Mm^Xm, Mm^Xm, Mm^Xm, Mm^Xm, Mm, Mm^Xm, Mm^Xm, Wog, Mm^Xm, Gll^Fp, Mm^Xm, Mm^Xm, Mm^Xm, Mm^Xm, Mm^Xm, Gg, Qxu, Mm^Xm, Mm^Xm, Gg, Mm^Xm, Gg, Mm^Xm, Mm^Xm, Mm^Xm, Mm^Xm, Mm^Xm, Mm^Xm
Mm^Xm, Mm^Xm, Gll^Fp, Mm^Xm, Mm^Xm, Mm^Xm, Mm^Xm, Wog, Mm^Xm, Gll^Fp, Gg^Gvs, Mm^Xm, Re, Re, Re, Mm^Xm, Qxu, Mm^Xm, Mm^Xm, Mm^Xm, Gll^Fp, Mm^Xm, Mm^Xm, Mm, Mm^Xm, Mm^Xm, Mm^Xm, Mm^Xm
Mm^Xm, Gll^Fp, Gg^Gvs, Gll^Fp, Gg^Gvs, Mm^Xm, Mm^Xm, Wog, Gg, Gg^Gvs, Re, Re, Mm^Xm, Hh, Gll^Fp, Re, Qxu^Bw\, Gll^Fp, Re, Re, Re, Gll^Fp, Gll^Fp, 3 Gll^Fp, Gll^Fp, Mm^Xm, Mm^Xm, Mm^Xm
Mm^Xm, Gll^Fp, Gg^Gvs, Gg^Gvs, Gg^Gvs, Gg^Gvs, Ce, Wog, Wog^Bw/, Re, Gg^Gvs, Gll^Fp, Gll^Fp, Mm^Xm, Mm^Xm, Gll^Fp, Qxu, Re, Mm^Xm, Hh, Gll^Fp, Re, Re, Re, Re, Gll^Fp, Mm^Xm, Mm^Xm
Mm^Xm, Gs^Vh, Re, Re, Re, Re, Ke, 1 Ce, Ww, Gd^Ecf, Mm^Xm, Mm^Xm, Mm^Xm, Mm^Xm, Mm^Xm, Mm^Xm, Mm^Xm, Qxu, Mm^Xm, Gll^Fp, Gll^Fp, Gll^Fp, Gll^Fp, Gll^Fp, Gll^Fp, Re, Gll^Fp, Mm^Xm
Mm^Xm, Gll^Fp, Gll^Fp, Gg^Gvs, Gg^Gvs, Gg^Gvs, Gs^Vh, Ce, Ww, Mm^Xm, Mm^Xm, Mm^Xm, Mm^Xm, 2 Mm^Xm, Mm^Xm, Mm^Xm, Mm^Xm, Qxu, Mm^Xm, Mm^Xm, Mm^Xm, Gll^Fp, Gll^Fp, Gll^Fp, Mm^Xm, Re, Mm, Mm^Xm
Mm^Xm, Gll^Fp, Gll^Fp, Gg^Gvs, Gll^Fp, Gll^Fp, Mm^Xm, Mm^Xm, Ww, Mm^Xm, Mm^Xm, Mm^Xm, Mm^Xm, Mm^Xm, Gll^Fp, Mm^Xm, Mm^Xm, Qxu, Gll^Fp, Mm, Gll^Fp, Mm^Xm, Mm^Xm, Mm^Xm, Gll^Fp, Re, Mm, Mm^Xm
Mm^Xm, Mm^Xm, Gll^Fp, Gll^Fp, Mm^Xm, Mm^Xm, Mm^Xm, Mm^Xm, Mm^Xm, Ww, Ww, Mm, Mm, Gll^Fp, Mm^Xm, Mm, Mm, Qxu^Bw/, Mm^Xm, Mm^Xm, Mm^Xm, Gll^Fp, Md, Gll^Fp, Mm^Xm, Re, Mm^Xm, Mm^Xm
Gg, Mm^Xm, Mm^Xm, Mm^Xm, Mm^Xm, Mm^Xm, Mm^Xm, Mm^Xm, Mm^Xm, Mm^Xm, Wog, Mm^Xm, Ww, Mm^Xm, Mm^Xm, Mm^Xm, Mm^Xm, Qxu, Mm^Xm, Mm^Xm, Mm^Xm, Mm^Xm, Mm^Xm, Mm^Xm, Mm^Xm, Re, Mm^Xm, Mm^Xm
