Mm^Xm, Wwg, Wwg, Wog, Wog, Wog, Wog, Wog, Wog, Wog, Wog, Wog, Wog, Wog, Wog, Wog, Wwg, Wwg
Mm^Xm, Mm^Xm, Mm^Xm, Wwg, Wwg, Wog, Wwg, Wwg, Wwg, Wwg, Wwg, Wog, Wwg, Wwg, Wwg, Wwg, Mm^Xm, Mm^Xm
Mm^Xm, Mm^Xm, Mm^Xm, Mm^Xm, Ds, Wwg, Ds, Ds, Ds, Ds, Ds, Wwg, Ds, Ds, Mm^Xm, Mm^Xm, Mm^Xm, Mm^Xm
Mm^Xm, Mm^Xm, Mm^Xm, Mm^Xm, Ds, Ds, Mm^Xm, Mm^Xm, Mm^Xm, Re, Co, Ds, Mm^Xm, Gll^Fp, Mm^Xm, Mm^Xm, Mm^Xm, Mm^Xm
Mm^Xm, Mm^Xm, Mm^Xm, Gs, Mm^Xm, Mm^Xm, Gs, Re, Re, Re, Ko, Re, Gll^Fp, Mm^Xm, Mm^Xm, Mm^Xm, Mm^Xm, Mm^Xm
Mm^Xm, Mm^Xm, Mm^Xm, Mm^Xm, Mm^Xm, Gs, Re, Re, Mm^Xm, Gll^Fp, Mm^Xm, Re, Mm^Xm, Mm^Xm, Mm^Xm, Mm^Xm, Mm^Xm, Mm^Xm
Mm^Xm, Mm^Xm, Mm^Xm, Mm^Xm, Mm^Xm, Gll^Fp, Re, Gs, Gs, Mm^Xm, Mm^Xm, Re, Mm^Xm, Mm^Xm, Mm^Xm, Mm^Xm, Mm^Xm, Mm^Xm
Rr^Vhc, Rrc, Mm^Xm, Mm^Xm, Mm^Xm, Mm^Xm, Re, Gs, Mm^Xm, Mm^Xm, Mm^Xm, Re, Mm^Xm, Mm^Xm, Mm^Xm, Mm^Xm, Mm^Xm, Mm^Xm
Rrc, Rrc, Mm^Xm, Mm^Xm, Re, Re, Mm^Xm, Gll^Fp, Mm^Xm, Mm^Xm, Mm^Xm, Re, Re, Gll^Fp, Mm^Xm, Mm^Xm, Mm^Xm, Mm^Xm
Rrc, Rrc, Rrc, Rr^Pw\o, Gll^Fp, Gll^Fp, Mm^Xm, Mm^Xm, Mm^Xm, Gs, Gs, Mm^Xm, Re, Mm^Xm, Gll^Fp, Mm^Xm, Mm^Xm, Mm^Xm
Rr^Vhc, Rrc, Mm^Xm, Mm^Xm, Mm, Mm^Xm, Mm^Xm, Mm^Xm, Mm^Xm, Mm^Xm, Mm^Xm, Re, Mm^Xm, Gll^Fp, Gll^Fp, Mm^Xm, Mm^Xm, Mm^Xm
Rrc, Rrc, Mm^Xm, Mm^Xm, Gll^Fp, Mm^Xm, Mm^Xm, Mm^Xm, Gll^Fp, Mm^Xm, Mm^Xm, Re, Re, Mm^Xm, Mm^Xm, Mm^Xm, Mm^Xm, Mm^Xm
Rrc, Mm^Xm, Mm^Xm, Mm, Mm^Xm, Mm, Gll^Fp, Mm^Xm, Co, Mm^Xm, Gs, Mm^Xm, Mm^Xm, Re, Mm^Xm, Mm^Xm, Mm^Xm, Mm^Xm
Rrc, Mm^Xm, Mm^Xm, Gll^Fp, Mm^Xm, Mm^Xm, Gll^Fp, Gs^Vh, Re, Ko, Re, Mm^Xm, Re, Re, Mm^Xm, Mm^Xm, Mm^Xm, Mm^Xm
Mm^Xm, Mm^Xm, Mm^Xm, Mm, Mm^Xm, Mm^Xm, Mm^Xm, Gll^Fp, Mm^Xm, Re, Mm^Xm, Re, Mm^Xm, Mm^Xm, Mm^Xm, Mm^Xm, Mm^Xm, Mm^Xm
Mm^Xm, Mm^Xm, Mm^Xm, Gll^Fp, Mm^Xm, Mm^Xm, Mm^Xm, Mm^Xm, Re, Re, Gll^Fp, Mm^Xm, Mm^Xm, Mm^Xm, Mm^Xm, Mm^Xm, Mm^Xm, Mm^Xm
Mm^Xm, Mm^Xm, Mm^Xm, Mm, Mm^Xm, Gll^Fp, Re, Re, Mm^Xm, Gll^Fp, Mm^Xm, Mm^Xm, Mm^Xm, Mm^Xm, Mm^Xm, Mm^Xm, Mm^Xm, Mm^Xm
Mm^Xm, Mm^Xm, Gll^Fp, Gll^Fp, Gs, Re, Mm^Xm, Gll^Fp, Mm^Xm, Mm^Xm, Mm^Xm, Mm^Xm, Mm^Xm, Mm^Xm, Mm^Xm, Mm^Xm, Mm^Xm, Mm^Xm
Mm^Xm, Mm^Xm, Gll^Fp, Gs, Gs, Re, Gll^Fp, Mm^Xm, Mm^Xm, Mm^Xm, Mm^Xm, Mm^Xm, Mm^Xm, Mm^Xm, Mm^Xm, Mm^Xm, Mm^Xm, Mm^Xm
Mm^Xm, Mm^Xm, Mm, Mm^Xm, Mm^Xm, Re, Mm^Xm, Mm^Xm, Mm^Xm, Mm^Xm, Mm^Xm, Mm^Xm, Mm^Xm, Mm^Xm, Mm^Xm, Mm^Xm, Mm^Xm, Mm^Xm
Mm^Xm, Gll^Fp, Mm^Xm, Mm^Xm, Re, Re, Gll^Fp, Mm^Xm, Mm^Xm, Mm^Xm, Mm^Xm, Mm^Xm, Mm^Xm, Mm^Xm, Mm^Xm, Mm^Xm, Mm^Xm, Mm^Xm
Mm^Xm, Gll^Fp, Mm, Mm^Xm, Re, Gll^Fp, Mm^Xm, Mm^Xm, Mm^Xm, Mm^Xm, Mm^Xm, Mm^Xm, Mm^Xm, Mm^Xm, Mm^Xm, Mm^Xm, Mm^Xm, Mm^Xm
Mm^Xm, Mm^Xm, Mm^Xm, Ce, Ke, Ce, Mm^Xm, Mm^Xm, Mm^Xm, Mm^Xm, Mm^Xm, Mm^Xm, Mm^Xm, Mm^Xm, Mm^Xm, Mm^Xm, Mm^Xm, Mm^Xm
Mm^Xm, Mm^Xm, Gs^Edb, Ce, Re, Ce, Gll^Fp, Mm^Xm, Mm^Xm, Mm^Xm, Mm^Xm, Mm^Xm, Mm^Xm, Mm^Xm, Mm^Xm, Mm^Xm, Mm^Xm, Mm^Xm
Mm^Xm, Mm^Xm, Gs^Edb, Gs^Edb, Gs^Edb, Gs^Edb, Gll^Fp, Mm^Xm, Mm^Xm, Mm^Xm, Mm^Xm, Mm^Xm, Mm^Xm, Mm^Xm, Mm^Xm, Mm^Xm, Mm^Xm, Mm^Xm
Mm^Xm, Mm^Xm, Gll^Fp, Gll^Fp, Gll^Fp, Gll^Fp, Gll^Fp, Mm^Xm, Mm^Xm, Mm^Xm, Mm^Xm, Mm^Xm, Mm^Xm, Mm^Xm, Mm^Xm, Mm^Xm, Mm^Xm, Mm^Xm
Mm^Xm, Mm^Xm, Mm^Xm, Gll^Fp, Mm^Xm, Mm^Xm, Mm^Xm, Mm^Xm, Mm^Xm, Mm^Xm, Mm^Xm, Mm^Xm, Mm^Xm, Mm^Xm, Mm^Xm, Mm^Xm, Mm^Xm, Mm^Xm
Mm^Xm, Mm^Xm, Mm^Xm, Mm^Xm, Mm^Xm, Mm^Xm, Mm^Xm, Mm^Xm, Mm^Xm, Mm^Xm, Mm^Xm, Mm^Xm, Mm^Xm, Mm^Xm, Mm^Xm, Mm^Xm, Mm^Xm, Mm^Xm
