Mm^Xm, Mm^Xm, Mm^Xm, Mm^Xm, Re, Mm^Xm, Mm^Xm, Mm^Xm, Mm^Xm, Mm^Xm, Mm^Xm, Mm^Xm, Mm^Xm, Mm^Xm
Mm^Xm, Mm^Xm, Mm^Xm, Mm^Xm, Rr^Pw|o, Mm^Xm, Mm^Xm, Mm^Xm, Mm^Xm, Mm^Xm, Mm^Xm, Mm^Xm, Mm^Xm, Mm^Xm
Mm^Xm, Mm^Xm, Rrc, Mm^Xm, Rrc, Mm^Xm, Rrc, Mm^Xm, Mm^Xm, Mm^Xm, Gs, Mm^Xm, Wwg, Wog
Mm^Xm, Rrc, Rrc, Rrc, Rrc, Rrc, Rrc, Mm^Xm, Mm^Xm, Mm^Xm, Gs, Ds, Wwg, Wog
Mm^Xm, Rrc, Ch, Ch, Rrc, Rrc, Rr^Vhc, Rrc, Mm^Xm, Mm^Xm, Ds, Ds, Wwg, Wog
Mm^Xm, Rrc, Rrc, Ch, Rrc, Ch, Ch, Rrc, Gs, Gs, Gs, Ds, Wwg, Wog
Mm^Xm, Mm^Xm, Rrc, Rrc, Rrc, Ch, Ch, Rrc, Gs, Gs, Gs, Ds, Wwg, Wog
Mm^Xm, Mm^Xm, Rrc, Ch, Ch, Rrc, Rrc, Rrc, Rrc, Gs, Gs, Ds, Wwg, Wog
Mm^Xm, Rrc, Rrc, Rr^Vhc, Rrc, Rrc, Rrc, Ce, Rrc, Rrc, Mm^Xm, Ds, Wwg, Wog
Mm^Xm, Rrc, Rrc, Rr^Vhc, Rrc, Rrc, Rrc, Rr^Vhc, Rrc, Mm^Xm, Mm^Xm, Ds, Wwg, Wog
Mm^Xm, Rrc, Rrc, Rrc, Rrc, Rrc, Rrc, Rrc, Rrc, Mm^Xm, Mm^Xm, Mm^Xm, Mm^Xm, Wog
Mm^Xm, Mm^Xm, Rrc, Kh, Rrc, Ch, Rrc, Rrc, Rrc, Rrc, Mm^Xm, Mm^Xm, Mm^Xm, Mm^Xm
Mm^Xm, Mm^Xm, Mm^Xm, Rrc, Mm^Xm, Rrc^Wm, Rrc, Rrc, Rrc, Rrc, Mm^Xm, Mm^Xm, Mm^Xm, Mm^Xm
Mm^Xm, Mm^Xm, Mm^Xm, Mm^Xm, Mm^Xm, Mm^Xm, Rr^Pw|o, Mm^Xm, Mm^Xm, Mm^Xm, Mm^Xm, Mm^Xm, Mm^Xm, Mm^Xm
Mm^Xm, Mm^Xm, Mm^Xm, Mm^Xm, Mm^Xm, Mm^Xm, Re, Mm^Xm, Mm^Xm, Mm^Xm, Mm^Xm, Mm^Xm, Mm^Xm, Mm^Xm
