Xue, Xue, Xue, Xue, Xue, Xue, Xue, Xue, Xue, Xue, Xue, Xue, Xue, Xue, Xue, Xue, Xue, Xue, Xue, Xue, Xue, Xue, Xue, Xue, Xue, Xue, Xue, Xue, Xue, Xue, Xue, Xue, Xue, Xue, Xue, Xue, Xue, Xue, Xue, Xue, Xue, Xue, Xue, Xue, Xue, Xue, Xue, Xue, Xos, Xos, Xos, Xos, Xos, Xos, Xos, Xos, Xos, Xos, Xos, Xos, Xos^Efs, Xos, Xos^Efs, Xos, Xos^Efs, Xos, Xos, Xos, Xos, Xos
Xue, Xue, Xue, Xue, Xue, Xue, Xue, Xue, Xue, Xue, Xue, Xue, Xue, Xue, Xue, Xue, Xue, Xue, Xue, Xue, Xue, Xue, Xue, Xue, Xue, Xue, Xue, Xue, Xue, Xue, Xue, Xue, Xue, Xue, Xue, Xue, Xue, Xue, Xue, Xue, Xue, Xue, Xue, Xue, Xue, Xue, Xue, Xue, Xos, Xos, Xos, Xos, Xos, Xos, Xos, Xos, Xos, Xos, Xos, Xos^Efs, Urb, Xos^Efs, Urb, Xos^Efs, Urb, Xos^Efs, Xos^Efs, Xos, Xos, Xos
Xue, Xue, Xue, Xue, Xue, Xue, Xue, Xue, Xue, Xue, Xue, Xue, Xue, Xue, Xue, Xue, Xue, Xue, Xue, Xue, Xue, Xue, Xue, Xue, Xue, Xue, Xue, Xue, Xue, Xue, Xue, Xue, Xue, Xue, Xue, Xue, Xue, Xue, Xue, Xue, Xue, Xue, Xue, Xue, Xue, Xue, Xue, Xue, Xos, Xos, Xos, Xos, Xos, Xos, Xos, Xos, Xos, Xos, Xos, Xos^Efs, Urb, Urb, Urb, Urb, Urb, Urb, Xos^Efs, Xos, Xos, Xos
Xue, Xue, Xue, Xue, Xue, Xue, Xue, Xue, Xue, Xue, Xue, Xue, Xue, Xue, Xue, Xue, Xue, Xue, Xue, Xue, Xue, Xue, Xue, Xue, Xue, Xue, Xue, Xue, Xue, Xue, Xue, Xue, Xue, Xue, Xue, Xue, Xue, Xue, Xue, Xue, Xue, Xue, Xue, Xue, Xue, Xue, Xue, Xue, Xos^Efs, Xos^Efs, Xos^Efs, Xos^Efs, Xos^Efs, Xos^Efs, Xos^Efs, Xos, Xos, Xos, Xos, Xos^Efs, Urb, Urb, Ce, Ke, Ce, Urb, Xos^Efs, Xos, Xos, Xos
Xue, Xue, Xue, Xue, Xue, Xue, Xue, Xue, Xue, Xue, Xue, Xue, Xue, Xue, Xue, Xue, Uue, Xue, Xue, Xue, Xue, Xue, Xue, Xue, Xue, Xue, Xue, Xue, Xue, Xue, Xue, Xue, Xue, Xue, Xue, Xue, Xue, Xue, Xue, Xue, Xue, Xue, Xue, Xue, Xue, Xue, Xue, Xue, Xos^Efs, Urb, Xos^Efs, Urb, Urb, Urb, Urb, Xos^Efs, Xos, Xos, Xos, Xos^Efs, Urb, Urb, Urb, Ce, Urb, Urb, Xos^Efs, Xos, Xos, Xos
Xue, Xue, Xue, Xue, Xue, Xue, Xue, Xue, Xue, Xue, Xue, Xue, Uue, Uue, Xue, Xue, Uue, Uue, Xue, Xue, Xue, Xue, Xue, Xue, Xue, Xue, Xue, Xue, Xue, Xue, Xue, Xue, Xue, Xue, Xue, Xue, Xue, Xue, Xue, Xue, Uue, Xue, Xue, Xue, Xue, Xue, Xue, Xos^Efs, Urb, Urb, Urb, Urb, Urb, Xos^Efs, Urb, Xos^Efs, Xos, Xos, Xos, Xos^Efs, Urb, Urb, Urb, Urb, Urb, Urb, Xos^Efs, Xos, Xos, Xos
Xue, Xue, Xue, Xue, Xue, Xue, Xue, Xue, Xue, Xue, Xue, Xue, Uue, Uue, Xue, Xue, Xue, Uue, Xue, Xue, Xue, Xue, Xue, Xue, Uue, Xue, Uue, Xue, Uue, Xue, Xue, Xue, Xue, Xue, Xue, Xue, Xue, Xue, Xue, Xue, Uue, Uue, Xue, Xue, Xue, Xue, Xue, Xos^Efs, Urb, Urb, Urb, Urb, Urb, Urb, Urb, Xos^Efs, Xos, Xos, Xos, Xos^Efs, Urb, Urb, Urb, Urb, Urb, Urb, Xos^Efs, Xos, Xos, Xos
Xue, Xue, Xue, Xue, Xue, Xue, Xue, Xue, Xue, Xue, Xue, Xue, Xue, Uue, Xue, Xue, Xue, Uue, Uue, Xue, Uue, Xue, Uue, Uue, Uue, Uue, Uue, Uue, Uue, Xue, Xue, Uue, Uue, Xue, Xue, Xue, Xue, Xue, Xue, Xue, Uue, Uue, Xue, Xue, Xue, Xue, Xue, Xos^Efs, Urb, Urb, Urb, Urb, Urb, Urb, Urb, Xos^Efs, Xos, Xos, Xos, Xos^Efs, Urb, Urb, Urb, Urb, Urb, Urb, Xos^Efs, Xos, Xos, Xos
Xue, Xue, Xue, Xue, Xue, Xue, Xue, Xue, Xue, Xue, Xue, Xue, Xue, Uue, Uue, Xue, Xue, Uue, Uue, Uue, Xue, Uue, Xue, Xue, Xue, Uue, Xue, Xue, Xue, Xue, Xue, Uue, Uue, Xue, Xue, Xue, Xue, Xue, Xos^Efs, Xue, Uue, Uue, Xos^Efs, Xue, Xue, Xue, Xos^Efs, Xos^Efs, Urb, Xos^Efs, Urb, Urb, Urb, Urb, Urb, Xos^Efs, Xos, Xos, Xos, Xos^Efs, Urb, Urb, Urb, Urb, Urb, Urb, Xos^Efs, Xos^Efs, Xos^Efs, Xos
Xue, Xue, Xue, Xue, Xue, Xue, Xue, Xue, Uue, Xue, Uue, Xue, Xue, Uue, Uue, Xue, Xue, Xue, Xue, Xue, Xue, Xue, Xue, Xue, Xue, Uue, Xue, Xue, Xue, Xue, Xue, Xue, Uue, Xue, Xue, Xue, Xos^Efs, Xos^Efs, Urb, Xos^Efs, Urb, Xos^Efs, Urb, Xos^Efs, Xos^Efs, Xos^Efs, Urb, Xos^Efs, Urb, Urb, Urb, Urb, Urb, Urb, Urb, Xos^Efs, Xos^Efs, Xos, Xos^Efs, Xos^Efs, Urb, Urb, Urb, Urb, Urb, Urb, Urb, Urb, Urb, Xos^Efs
Xue, Xue, Xue, Xue, Xue, Xue, Xue, Uue, Uue, Uue, Xue, Uue, Xue, Xue, Uue, Xue, Xue, Xue, Xue, Xue, Xue, Xue, Xue, Xue, Xue, Uue, Xue, Xue, Xue, Xue, Xue, Xue, Uue, Uue, Uue, Xue, Uue, Urb, Urb, Urb, Urb, Urb, Urb, Urb, Xuc, Urb, Urb, Urb, Urb, Urb, Urb, Urb, Urb, Urb, Urb, Xos^Efs, Urb, Xos^Efs, Urb, Xos^Efs, Urb, Urb, Urb, Urb, Urb, Urb, Urb, Urb, Urb, Xos^Efs
Xue, Xue, Xue, Xue, Xue, Xue, Xue, Uue, Xue, Xue, Xue, Uue, Xue, Xue, Uue, Xue, Xue, Xue, Uue, Uue, Uue, Xue, Uue, Xue, Uue, Uue, Uue, Xue, Uue, Xue, Xue, Xue, Xue, Uue, Xue, Uue, Xos^Efs, Urb, Urb, Urb, Xos^Efs, Urb, Uue, Urb, Xos^Efs, Urb, Urb, Urb, Urb, Urb, Urb, Urb, Urb, Urb, Urb, Xos^Efs, Urb, Urb, Urb, Urb, Urb, Urb, Urb, Urb, Urb, Urb, Urb, Urb, Urb, Xos^Efs
Xue, Xue, Xue, Xue, Xue, Xue, Xue, Xue, Xue, Xue, Xue, Uue, Uue, Xue, Uue, Uue, Xue, Xue, Uue, Uue, Xue, Uue, Xue, Uue, Xue, Uue, Xue, Uue, Xue, Uue, Xue, Xue, Xue, Xue, Xue, Xue, Xos^Efs, Urb, Urb, Urb, Xos^Efs, Xos, Uue, Xos^Efs, Xue, Xos^Efs, Urb, Urb, Urb, Urb, Urb, Urb, Urb, Xos^Efs, Urb, Xuc, Urb, Urb, Urb, Urb, Urb, Urb, Urb, Urb, Urb, Urb, Urb, Urb, Urb, Xos^Efs
Xue, Xue, Xue, Xue, Xue, Xue, Xue, Xue, Xue, Xue, Xue, Uue, Uue, Xue, Xue, Uue, Xue, Xue, Uue, Xue, Xue, Xue, Xos^Efs, Xos^Efs, Xos^Efs, Xos^Efs, Xos^Efs, Xue, Xue, Uue, Xue, Xue, Xue, Xue, Xue, Xue, Xos^Efs, Urb, Urb, Urb, Xos^Efs, Uue, Uue, Xue, Xue, Xos^Efs, Urb, Urb, Urb, Urb, Urb, Urb, Urb, Urb, Urb, Xos^Efs, Urb, Urb, Urb, Urb, Urb, Urb, Urb, Urb, Urb, Urb, Urb, Urb, Urb, Xos^Efs
Xue, Xue, Xue, Xue, Xue, Xue, Xue, Xue, Xue, Xue, Xue, Xue, Uue, Xue, Xue, Uue, Xue, Xue, Uue, Xue, Xue, Xos^Efs, Urb, Urb, Urb, Urb, Urb, Xos^Efs, Xue, Uue, Xue, Xue, Xue, Xue, Uue, Xue, Uue, Urb, Urb, Urb, Xos^Efs, Uue, Uue, Xue, Xue, Xos^Efs, Urb, Xos^Efs, Urb, Urb, Xos^Efs, Urb, Urb, Xos^Efs, Urb, Xos^Efs, Xos^Efs, Urb, Xos^Efs, Urc, Urb, Xos^Efs, Urc, Urb, Xos^Efs, Urc, Urb, Xos^Efs, Urb, Xos^Efs
Xue, Xue, Xue, Xue, Xue, Xue, Xue, Xue, Xue, Xue, Xue, Xue, Uue, Xue, Uue, Uue, Uue, Uue, Uue, Xue, Xue, Xos^Efs, Urb, Urb, Urb, Urb, Urb, Xos^Efs, Xue, Uue, Xue, Xue, Uue, Uue, Xue, Uue, Xos^Efs, Urb, Urb, Urb, Xos^Efs, Uue, Uue, Xue, Xue, Xos^Efs, Xos^Efs, Urb, Xos^Efs, Urb, Xos^Efs, Urb, Xos^Efs, Urb, Xos^Efs, Xos^Efs, Xos^Efs, Urb, Xos^Efs, Urb, Xos^Efs, Urb, Xos^Efs, Urb, Xos^Efs, Urb, Xos^Efs, Urb, Xos^Efs, Xos^Efs
Xue, Xue, Xue, Xue, Xue, Xue, Xue, Xue, Xue, Xue, Xue, Uue, Uue, Uue, Uue, Uue, Uue, Uue, Uue, Xue, Xue, Xos^Efs, Xos^Efs, Urb, Urb, Urb, Xos^Efs, Xos^Efs, Xue, Uue, Xue, Xue, Uue, Xue, Xue, Xue, Xos^Efs, Urb, Urb, Urb, Xos^Efs, Xue, Xue, Xue, Xue, Xue, Xos, Xos^Efs, Xos, Xos^Efs, Xos, Xos^Efs, Xos, Xos^Efs, Xos, Xos, Xos, Xos^Efs, Xos, Xos^Efs, Xos, Xos^Efs, Xos, Xos^Efs, Xos, Xos^Efs, Xos, Xos^Efs, Xos, Xos
Xue, Xue, Xos^Efs, Xos^Efs, Xos^Efs, Xos^Efs, Xos^Efs, Xos^Efs, Xos^Efs, Xue, Xue, Uue, Uue, Uue, Xue, Uue, Xue, Uue, Uue, Xue, Xue, Xue, Xue, Xos^Efs, Urb^Pw|, Xos^Efs, Xue, Xue, Xue, Uue, Xue, Xue, Uue, Xue, Xue, Xue, Xos^Efs, Urb, Urb^Pr|, Urb, Xos^Efs, Xue, Xue, Xue, Xue, Xue, Xos, Xos, Xos, Xos, Xos, Xos, Xos, Xos, Xos, Xos, Xos, Xos, Xos, Xos, Xos, Xos, Xos, Xos, Xos, Xos, Xos, Xos, Xos, Xos
Xue, Xue, Xos^Efs, Urb, Urb, Urb, Urb, Urb, Urb, Xos^Efs, Xue, Xue, Uue, Xue, Uue, Xue, Uue, Uue, Uue, Xue, Xue, Xue, Xos^Efs, Xos^Efs, Urb, Xos^Efs, Xos^Efs, Xue, Xue, Uue, Uue, Uue, Uue, Xue, Xue, Xue, Xos^Efs, Xos^Efs, Urb, Xos^Efs, Xos^Efs, Xue, Xue, Xue, Xos, Xos, Xos, Xos, Xos, Xos, Xos, Xos, Xos, Xos, Xos, Xos, Xos, Xos, Xos, Xos, Xos, Xos, Xos, Xos, Xos, Xos, Xos, Xos, Xos, Xos
Xue, Xue, Xos^Efs, Urb, Urb, Urb, Urb, Urb, Urb, Xos, Uue, Xue, Uue, Xue, Uue, Uue, Uue, Uue, Uue, Xue, Xue, Xos^Efs, Urb, Urb, Urb, Urb, Urb, Xos^Efs, Xue, Uue, Xue, Uue, Xue, Xue, Xue, Xos^Efs, Urb, Urb, Urb, Urb, Urb, Xos^Efs, Xos, Xos, Xos, Xos, Xos, Xos, Xos, Xos, Xos, Xos, Xos, Xos, Xos, Xos, Xos, Xos, Xos, Xos, Xos, Xos, Xos, Xos, Xos, Xos, Xos, Xos, Xos, Xos
Xue, Xue, Xos^Efs, Urb, Urb, Urb, Urb, Urb, Urb, Uue, Xue, Uue, Uue, Xue, Xue, Uue, Xue, Uue, Xue, Xue, Xue, Xos^Efs, Urb, Urb, Urb, Urb, Urb, Xos^Efs, Xue, Uue, Xue, Xue, Xue, Xue, Xos^Efs, Xos^Efs, Urb, Urb, Urb, Urb, Urb, Xos^Efs, Xos^Efs, Xos, Xos, Xos, Xos, Xos, Xos, Xos, Xos, Xos, Xos, Xos, Xos, Xos, Xos, Xos, Xos, Xos, Xos, Xos, Xos, Xos, Xos, Xos, Xos, Xos, Xos, Xos
Xue, Xue, Xos^Efs, Urb, Urb, Urb, Urb, Urb, Urb, Xos^Efs, Xue, Xue, Uue, Xue, Xue, Xue, Xue, Uue, Xue, Xue, Xue, Xos^Efs, Urb, Urb, Urb, Urb, Urb, Xos^Efs, Xue, Uue, Xue, Xue, Xos^Efs, Xos^Efs, Urb, Urb, Urb, Urb, Urb, Urb, Urb, Urb, Urb, Xos^Efs, Xos^Efs, Xos, Xos, Xos, Xos, Xos, Xos, Xos, Xos, Xos, Xos, Xos, Xos, Xos, Xos, Xos, Xos, Xos, Xos, Xos, Xos, Xos, Xos, Xos, Xos, Xos
Xue, Xue, Xue, Xos^Efs, Xos^Efs, Xos^Efs, Xos^Efs, Xos^Efs, Xos^Efs, Xos^Efs, Xue, Uue, Uue, Uue, Uue, Uue, Uue, Uue, Uue, Xue, Xue, Xos^Efs, Urb, Urb, Urb, Urb, Urb, Xos^Efs, Xue, Uue, Xue, Xos^Efs, Urb, Xos^Efs, Urb, Urb, Urb, Urb, Urb, Urb, Urb, Urb, Urb, Xos^Efs, Urb, Xos^Efs, Xos, Xos, Xos, Xos, Xos, Xos, Xos, Xos, Xos, Xos, Xos, Xos, Xos, Xos, Xos, Xos, Xos, Xos, Xos, Xos, Xos, Xos, Xos, Xos
Xue, Xue, Xue, Xue, Xue, Xue, Xue, Xue, Xue, Xue, Xue, Uue, Uue, Uue, Uue, Uue, Uue, Uue, Uue, Xue, Xue, Xos^Efs, Xos^Efs, Uue, Xos^Efs, Xos^Efs, Xos^Efs, Xos^Efs, Xue, Uue, Xue, Xos^Efs, Urb, Urb, Urb, Urb, Xos^Efs, Urb, Urb, Urb, Xos^Efs, Urb, Urb, Urb, Urb, Xos^Efs, Xos, Xos, Xos, Xos, Xos, Xos, Xos, Xos, Xos, Xos, Xos, Xos, Xos, Xos, Xos, Xos, Xos, Xos, Xos, Xos, Xos, Xos, Xos, Xos
Xue, Xue, Xue, Xue, Xue, Xue, Xue, Xue, Xue, Xue, Xue, Xue, Uue, Xue, Xue, Uue, Xue, Uue, Xue, Xue, Xue, Xue, Xue, Uue, Xue, Xue, Xue, Xue, Xue, Uue, Xue, Xos^Efs, Urb, Urb, Urb, Urb, Urb, Urb, Urb, Urb, Urb, Urb, Urb, Urb, Urb, Xos^Efs, Xos, Xos, Xos, Xos, Xos, Xos, Xos, Xos, Xos, Xos, Xos, Xos, Xos, Xos, Xos, Xos, Xos, Xos, Xos, Xos, Xos, Xos, Xos, Xos
Xue, Xue, Xue, Xue, Xue, Xue, Xue, Xue, Xue, Xue, Xue, Xue, Uue, Xue, Xue, Uue, Xue, Uue, Uue, Xue, Uue, Xue, Uue, Uue, Uue, Uue, Uue, Xue, Uue, Uue, Xue, Xos^Efs, Urb, Urb, Urb, Xos^Efs, Urb, Urb, Urb, Urb, Urb, Xos^Efs, Urb, Urb, Urb, Xos^Efs, Xos, Xos, Xos, Xos, Xos, Xos, Xos, Xos, Xos, Xos, Xos, Xos, Xos, Xos, Xos, Xos, Xos, Xos, Xos, Xos, Xos, Xos, Xos, Xos
Xue, Xue, Xue, Xue, Xue, Xue, Xue, Xue, Uue, Uue, Uue, Uue, Xue, Xue, Uue, Uue, Uue, Xue, Xue, Uue, Xue, Uue, Uue, Uue, Uue, Uue, Uue, Uue, Xue, Xue, Xue, Xos^Efs, Urb, Urb, Urb, Urb, Urb, Urb, Urb, Urb, Urb, Urb, Urb, Urb, Urb, Xos^Efs, Xos, Xos, Xos, Xos, Xos, Xos, Xos, Xos, Xos, Xos, Xos, Xos, Xos, Xos, Xos, Xos, Xos, Xos, Xos, Xos, Xos, Xos, Xos, Xos
Xue, Xue, Xue, Xue, Xue, Xue, Xue, Xue, Xue, Uue, Xue, Xue, Xue, Xue, Xue, Uue, Xue, Xue, Xue, Xue, Xue, Xue, Xue, Xue, Xue, Uue, Uue, Xue, Xue, Xue, Xue, Xos^Efs, Urb, Urb, Urb, Xos^Efs, Urb, Urb, Urb, Urb, Urb, Xos^Efs, Urb, Urb, Urb, Xos^Efs, Xos, Xos, Xos, Xos, Xos, Xos, Xos, Xos, Xos, Xos, Xos, Xos, Xos, Xos, Xos, Xos, Xos, Xos, Xos, Xos, Xos, Xos, Xos, Xos
Xue, Xue, Xue, Xue, Xue, Xue, Xue, Xue, Xue, Xue, Xue, Xue, Xue, Xue, Xue, Xue, Xue, Xue, Xue, Xue, Xue, Xue, Xue, Xue, Xue, Xue, Uue, Xue, Xue, Xue, Xue, Xos^Efs, Urb, Urb, Urb, Urb, Xos^Efs, Urb, Urb, Urb, Xos^Efs, Urb, Urb, Urb, Urb, Xos^Efs, Xos, Xos, Xos, Xos, Xos, Xos, Xos, Xos, Xos, Xos, Xos, Xos, Xos, Xos, Xos, Xos, Xos, Xos, Xos, Xos, Xos, Xos, Xos, Xos
Xue, Xue, Xue, Xue, Xue, Xue, Xue, Xue, Xue, Xue, Xue, Xue, Xue, Xue, Xue, Xue, Xue, Xue, Xue, Xue, Xue, Xue, Xue, Xue, Xue, Xue, Uue, Xue, Xue, Xue, Uue, Xos^Efs, Urb, Urb, Urb, Urb, Urb, Urb, Urb, Urb, Urb, Urb, Urb, Urb, Urb, Xos^Efs, Xos, Xos, Xos, Xos, Xos, Xos, Xos, Xos, Xos, Xos, Xos, Xos, Xos, Xos, Xos, Xos, Xos, Xos, Xos, Xos, Xos, Xos, Xos, Xos
Xue, Xue, Xue, Xue, Xue, Xue, Xue, Xue, Xue, Xue, Xue, Xue, Xue, Xue, Xue, Xue, Xue, Xue, Xue, Xue, Uue, Xue, Uue, Xue, Uue, Uue, Uue, Uue, Uue, Uue, Uue, Xos^Efs, Xos^Efs, Xos^Efs, Urb, Urb, Urb, Urb, Urb^Pr|, Urb, Urb, Urb, Urb, Xos^Efs, Xos^Efs, Xos^Efs, Xos, Xos, Xos, Xos, Xos, Xos, Xos, Xos, Xos, Xos, Xos, Xos, Xos, Xos, Xos, Xos, Xos, Xos, Xos, Xos, Xos, Xos, Xos, Xos
Xue, Xue, Xue, Xue, Xue, Xue, Xue, Xue, Xue, Xue, Xue, Xue, Xue, Xue, Xue, Xue, Xue, Xue, Xue, Uue, Uue, Uue, Xue, Uue, Xue, Uue, Xue, Uue, Xue, Uue, Xue, Xue, Xue, Xos^Efs, Xos^Efs, Urb, Xos^Efs, Xos^Efs, Urb, Xos^Efs, Xos^Efs, Urb, Xos^Efs, Xos^Efs, Xos, Xos, Xos, Xos, Xos, Xos, Xos, Xos, Xos, Xos, Xos, Xos, Xos, Xos, Xos, Xos, Xos, Xos, Xos, Xos, Xos, Xos, Xos, Xos, Xos, Xos
Xue, Xue, Xue, Xue, Xue, Xue, Xue, Xue, Xue, Xue, Xue, Xue, Xue, Xue, Xue, Xue, Xue, Xue, Xue, Xue, Xue, Xue, Xue, Xue, Xue, Xue, Xue, Xue, Xue, Xue, Xue, Xue, Xue, Xue, Xue, Xos^Efs, Xos^Efs, Urb, Urb, Urb, Xos^Efs, Xos^Efs, Xos, Xos, Xos, Xos, Xos, Xos, Xos, Xos, Xos, Xos, Xos, Xos, Xos, Xos, Xos, Xos, Xos, Xos, Xos, Xos, Xos, Xos, Xos, Xos, Xos, Xos, Xos, Xos

