Mm^Xm, Gs, Mm^Xm, Mm^Xm, Mm^Xm, Mm^Xm, Mm^Xm, Mm^Xm, Mm^Xm, Mm^Xm, Mm^Xm, Mm^Xm, Mm^Xm, Mm^Xm, Mm^Xm
Mm^Xm, Mm^Xm, Gll^Fp, Mm^Xm, Mm^Xm, Mm^Xm, Mm^Xm, Mm^Xm, Mm^Xm, Mm^Xm, Mm^Xm, Mm^Xm, Mm^Xm, Mm^Xm, Mm^Xm
Mm^Xm, Gll^Fp, Re, Gll^Fp, Gll^Fp, Gll^Fp, Gll^Fp, Mm^Xm, Mm^Xm, Mm^Xm, Mm^Xm, Mm^Xm, Mm^Xm, Mm^Xm, Mm^Xm
Mm^Xm, Mm^Xm, Mm^Xm, Mm^Xm, Gll^Fp, Gll^Fp, Gll^Fp, Gll^Fp, Gll^Fp, Mm^Xm, Mm^Xm, Mm^Xm, Mm^Xm, Mm^Xm, Mm^Xm
Mm^Xm, Mm^Xm, Mm^Xm, Gll^Fp, Gll^Fp, Gll^Fp, Re^Vl, Gll^Fp, Mm^Xm, Mm^Xm, Mm^Xm, Mm^Xm, Mm^Xm, Mm^Xm, Mm^Xm
Mm^Xm, Mm^Xm, Mm^Xm, Gll^Fp, Gll^Fp, Gll^Fp, Re, Gs, Gs, Mm^Xm, Mm^Xm, Mm^Xm, Mm^Xm, Mm^Xm, Mm^Xm
Mm^Xm, Mm^Xm, Mm^Xm, Mm^Xm, Mm^Xm, Re, Re, Gs, Re, Mm^Xm, Gll^Fp, Mm^Xm, Mm^Xm, Mm^Xm, Mm^Xm
Mm^Xm, Mm^Xm, Re, Re, Re^Vl, Mm^Xm, Mm^Xm, Re, Mm^Xm, Re, Re, Re, Rr^Pw/, Mm^Xm, Re
Mm^Xm, Mm, Re^Vl, Re, Re, Re^Vl, Mm^Xm, Mm^Xm, Gll^Fp, Mm^Xm, Re, Re, Qxe, Re, Gll^Fp
Mm^Xm, Re^Br|, Re^Br\, Re^Br/, Re^Br\, Re^Br/, Mm^Xm, Gll^Fp, Re, Re, Qxe, Qxe, Qxe, Qxe, Qxe
Mm^Xm, Mm^Xm, Re, Re^Vl, Re^Vl, Re, Mm^Xm, Re, Re, Re, Gs, Qxe, Gll^Fp, Qxe, Qxe
Mm^Xm, Mm^Xm, Gs, Re, Re, Re^Vl, Re, Re, Gll^Fp, Gs, Qxe, Qxe, Gll^Fp, Qxe, Qxe
Mm^Xm, Mm^Xm, Mm^Xm, Mm^Xm, Mm^Xm, Re, Mm^Xm, Mm^Xm, Mm^Xm, Gs, Gs, Gll^Fp, Qxe, Qxe, Qxe
Mm^Xm, Mm^Xm, Mm^Xm, Mm^Xm, Mm^Xm, Mm^Xm, Mm^Xm, Mm^Xm, Mm^Xm, Mm^Xm, Re, Mm^Xm, Qxe, Qxe, Qxe
Mm^Xm, Mm^Xm, Mm^Xm, Mm^Xm, Mm^Xm, Mm^Xm, Mm^Xm, Mm^Xm, Gs, Re, Ce, Mm^Xm, Qxe, Qxe, Qxe
Mm^Xm, Mm^Xm, Mm^Xm, Mm^Xm, Mm^Xm, Mm^Xm, Mm^Xm, Mm^Xm, Mm^Xm, Ke, Mm^Xm, Mm^Xm, Qxe, Qxe, Qxe
Mm^Xm, Mm^Xm, Mm^Xm, Mm^Xm, Mm^Xm, Mm^Xm, Mm^Xm, Mm^Xm, Mm^Xm, Mm^Xm, Mm^Xm, Mm^Xm, Qxe, Qxe, Qxe
