Xuc, Xuc, Xuc, Xuc, Xuc, Xuc, Xuc, Xuc, Xuc, Xuc, Xuc, Xuc, Xuc, Xuc, Xuc, Xuc, Xuc, Xuc, Xuc, Xuc, Xuc, Xuc, Xuc, Xuc, Xuc, Xuc, Xuc, Xuc, Xuc, Xuc, Xuc, Xuc, Xuc, Xuc, Xuc, Xuc, Xuc, Xuc, Xuc, Xuc, Xuc, Xuc, Xuc, Xuc, Xuc, Xuc, Xuc, Xuc, Xuc, Xuc, Xuc, Xuc, Xuc, Xuc, Xuc, Xuc, Xuc, Xuc
Xuc, Xuc, Xuc, Xuc, Xuc, Xuc, Xuc, Xuc, Xuc, Xuc, Xuc, Xuc, Xuc, Xuc, Xuc, Xuc, Xuc, Xuc, Xuc, Xuc, Xuc, Xuc, Xuc, Xuc, Xuc, Xuc, Xuc, Xuc, Xuc, Xuc, Xuc, Xuc, Xuc, Xuc, Xuc, Xuc, Xuc^Efs, Xuc, Xuc^Efs, Xuc, Xuc^Efs, Xuc, Xuc, Xuc, Xuc, Xuc, Xuc, Xuc, Xuc, Xuc, Xuc, Xuc, Xuc, Xuc, Xuc, Xuc, Xuc, Xuc
Xuc, Xuc, Xuc, Xuc, Xuc, Xuc, Xuc, Xuc, Xuc, Xuc, Xuc, Xuc, Xuc, Xuc, Xuc, Xuc, Xuc, Xuc, Xuc, Xuc, Xuc, Xuc, Xuc, Xuc, Xuc, Xuc, Xuc, Xuc, Xuc, Xuc, Xuc, Xuc, Xuc, Xuc, Xuc^Efs, Xuc^Efs, Ur, Xuc^Efs, Ur, Xuc^Efs, Ur, Xuc^Efs, Xuc^Efs, Xuc, Xuc, Xuc, Xuc, Xuc, Xuc, Xuc, Xuc, Xuc, Xuc, Xuc, Xuc, Xuc, Xuc, Xuc
Xuc, Xuc, Xuc, Xuc, Xuc, Xuc, Xuc, Xuc, Xuc, Xuc, Xuc, Xuc, Xuc, Xuc, Xuc, Xuc, Xuc, Xuc, Xuc, Xuc, Xuc, Xuc, Xuc, Xuc, Xuc, Xuc, Xuc, Xuc, Xuc, Xuc, Xuc, Xuc, Xuc, Xuc, Xuc^Efs, Ur, Ur, Ur, Ur, Ur, Ur, Ur, Ur, Xuc^Efs, Xuc, Xuc, Xuc, Xuc, Xuc, Xuc, Xuc, Xuc, Xuc, Xuc, Xuc, Xuc, Xuc, Xuc
Xuc, Xuc, Xuc, Xuc, Xuc, Xuc, Xuc, Xuc, Xuc, Xuc, Xuc, Xuc, Xuc, Xuc, Xuc, Xuc, Xuc, Xuc, Xuc, Xuc, Xuc, Xuc, Xuc, Xuc, Xuc, Xuc, Xuc, Xuc, Xuc, Xuc, Xuc, Xuc, Xuc, Xuc, Xuc^Efs, Ur, Ur, Ur, Ur, Ur, Ur, Ur, Ur, Xuc^Efs, Xuc, Xuc, Xuc, Xuc, Xuc, Xuc, Xuc, Xuc, Xuc, Xuc, Xuc, Xuc, Xuc, Xuc
Xuc, Xuc, Xuc, Xuc, Xuc, Xuc, Xuc, Xuc, Xuc, Xuc, Xuc, Xuc, Xuc, Xuc, Xuc, Xuc, Xuc, Xuc, Xuc, Xuc, Xuc, Xuc, Xuc, Xuc, Xuc, Xuc, Xuc, Xuc, Xuc, Xuc, Xuc, Xuc, Xuc, Xuc, Xuc^Efs, Ur, Ur, Ur^Br|, Uu^Vud, Ur, Ur^Br|, Ur, Ur, Xuc^Efs, Xuc, Xuc, Xuc, Xuc, Xuc, Xuc, Xuc, Xuc, Xuc, Xuc, Xuc, Xuc, Xuc, Xuc
Xuc, Xuc, Xuc, Xuc, Xuc, Xuc, Xuc, Xuc, Xuc, Xuc, Xuc, Xuc, Xuc, Xuc, Xuc, Xuc, Xuc, Xuc, Xuc, Xuc, Xuc, Xuc, Xuc, Xuc, Xuc, Xuc, Xuc, Xuc, Xuc, Xuc, Xuc, Xuc, Xuc, Xuc, Xuc^Efs, Ur, Ur, Ur^Br|, Ur^Br|, Ur^Br|, Ur^Br|, Ur^Br|, Xuc^Efs, Xuc^Efs, Xuc, Xuc, Xuc, Xuc, Xuc, Xuc, Xuc, Xuc, Xuc, Xuc, Xuc, Xuc, Xuc, Xuc
Xuc, Xuc, Xuc, Xuc, Xuc, Xuc, Xuc, Xuc, Xuc, Xuc, Xuc, Xuc, Xuc, Xuc, Xuc, Xuc, Xuc, Xuc, Xuc, Xuc, Xuc, Xuc, Xuc, Xuc, Xuc, Xuc, Xuc, Xuc, Xuc, Xuc, Xuc, Xuc, Xuc, Xuc, Xuc^Efs, Ur, Ur, Ur^Br|, Ur^Br|, Ur^Br|, Ur^Br|, Ur^Br|, Xuc^Efs, Xuc, Xuc, Xuc, Xuc, Xuc, Xuc, Xuc, Xuc, Xuc, Xuc, Xuc, Xuc, Xuc, Xuc, Xuc
Xuc, Xuc, Xuc, Xuc, Xuc, Xuc, Xuc, Xuc, Xuc, Xuc, Xuc, Xuc, Xuc, Xuc, Xuc, Xuc, Xuc, Xuc, Xuc, Xuc, Xuc, Xuc, Xuc, Xuc, Xuc, Xuc, Xuc, Xuc, Xuc, Xuc, Xuc, Xuc, Xuc, Xuc, Xuc, Xuc^Efs, Ur, Ur^Br\, Ur^Br|, Ur^Br|, Ur^Br|, Ur^Br/, Xuc^Efs, Xuc, Xuc, Xuc, Xuc, Xuc, Xuc, Xuc, Xuc, Xuc, Xuc, Xuc, Xuc, Xuc, Xuc, Xuc
Xuc, Xuc, Xuc, Xuc, Xuc, Xuc, Xuc, Xuc, Xuc, Xuc, Xuc, Xuc, Xuc, Xuc, Xuc, Xuc, Xuc, Xuc, Xuc, Xuc, Xuc, Xuc, Xuc, Xuc, Xuc, Xuc, Xuc, Xuc, Xuc, Xuc, Xuc, Xuc, Xuc, Xuc, Xuc, Xuc^Efs, Xuc^Efs, Ur, Ur^Br\, Ur^Br|, Ur^Br|, Ur, Xuc^Efs, Xuc, Xuc, Xuc, Xuc, Xuc, Xuc, Xuc, Xuc, Xuc, Xuc, Xuc, Xuc, Xuc, Xuc, Xuc
Xuc, Xuc, Xuc, Xuc, Xuc, Xuc, Xuc, Xuc, Xuc, Xuc, Xuc, Xuc, Xuc, Xuc, Xuc, Xuc, Xuc, Xuc, Xuc, Xuc, Xuc, Xuc, Xuc, Xuc, Xuc, Xuc, Xuc, Xuc, Xuc, Xuc, Xuc, Xuc, Xuc, Xuc, Xuc, Xuc, Xuc, Xuc^Efs, Ur, Ur^Br|, Ur^Br|, Ur, Xuc^Efs, Xuc, Xuc, Xuc, Xuc, Xuc, Xuc, Xuc, Xuc, Xuc, Xuc, Xuc, Xuc, Xuc, Xuc, Xuc
Xuc, Xuc, Xuc, Xuc, Xuc, Xuc, Xuc, Xuc, Xuc, Xuc, Xuc, Xuc, Xuc, Xuc, Xuc, Xuc, Xuc, Xuc, Xuc, Xuc, Xuc, Xuc, Xuc, Xuc, Xuc, Xuc, Xuc, Xuc, Xuc, Xuc, Xuc, Xuc, Xuc, Xuc, Xuc, Xuc, Xuc, Xuc^Efs, Ur, Ur^Br|, Ur^Br|, Ur^Br\, Xuc^Efs, Xuc, Xuc, Xuc, Xuc, Xuc, Xuc, Xuc, Xuc, Xuc, Xuc, Xuc, Xuc, Xuc, Xuc, Xuc
Xuc, Xuc, Xuc, Xuc, Xuc, Xuc, Xuc, Xuc, Xuc, Xuc, Xuc, Xuc, Xuc, Xuc, Xuc, Xuc, Xuc, Xuc, Xuc, Xuc, Xuc, Xuc, Xuc, Xuc, Xuc, Xuc, Xuc, Xuc, Xuc, Xuc, Xuc, Xuc, Xuc, Xuc, Xuc, Xuc, Xuc, Xuc^Efs, Ur, Ur^Br\, Ur^Br|, Ur, Xuc^Efs, Xuc, Xuc, Xuc, Xuc, Xuc, Xuc, Xuc, Xuc, Xuc, Xuc, Xuc, Xuc, Xuc, Xuc, Xuc
Xuc, Xuc, Xuc, Xuc, Xuc, Xuc, Xuc, Xuc, Xuc, Xuc, Xuc, Xuc, Xuc, Xuc, Xuc, Xuc, Xuc, Xuc, Xuc, Xuc, Xuc, Xuc, Xuc, Xuc, Xuc, Xuc, Xuc, Xuc, Xuc, Xuc, Xuc, Xuc, Xuc, Ur, Ur, Ur, Xuc, Xuc^Efs, Xuc^Efs, Ur, Ur^Br|, Xuc^Efs, Xuc, Xuc, Xuc, Xuc, Xuc, Xuc, Xuc, Xuc, Xuc, Xuc, Xuc, Xuc, Xuc, Xuc, Xuc, Xuc
Xuc, Xuc, Xuc, Xuc, Xuc, Xuc, Xuc, Xuc, Xuc, Xuc, Xuc, Xuc, Xuc, Xuc, Xuc, Xuc, Xuc, Xuc, Xuc, Xuc, Xuc, Xuc, Xuc, Xuc, Xuc, Xuc, Xuc, Xuc, Xuc, Xuc, Xuc, Xuc, Xuc, Xuc, Ur, Ur, Ur, Xuc, Xuc^Efs, Ur, Ur^Br|, Xuc^Efs, Xuc, Xuc, Xuc, Xuc, Xuc, Xuc, Xuc, Xuc, Xuc, Xuc, Xuc, Xuc, Xuc, Xuc, Xuc, Xuc
Xuc, Xuc, Xuc, Xuc, Xuc, Xuc, Xuc, Xuc, Xuc, Xuc, Xuc, Xuc, Xuc, Xuc, Xuc, Xuc, Xuc, Xuc, Xuc, Xuc, Xuc, Xuc, Xuc, Xuc, Xuc, Xuc, Xuc, Xuc, Xuc, Xuc, Xuc, Xuc, Xuc, Xuc, Xuc^Efs, Ur, Xuc^Efs, Xuc, Xuc^Efs, Ur, Ur^Br|, Xuc^Efs, Xuc, Xuc, Xuc, Xuc, Xuc, Xuc, Xuc, Xuc, Xuc, Xuc, Xuc, Xuc, Xuc, Xuc, Xuc, Xuc
Xuc, Xuc, Xuc, Xuc, Xuc, Xuc, Xuc, Xuc, Xuc, Xuc, Xuc, Xuc, Xuc, Xuc, Xuc, Xuc, Xuc, Xuc, Xuc, Xuc, Xuc, Xuc, Xuc, Xuc, Xuc, Xuc, Xuc, Xuc, Xuc, Xuc, Xuc^Efs, Xuc, Xuc^Efs, Xuc^Efs, Ur, Xuc^Efs, Ur, Xuc^Efs, Xuc^Efs, Ur, Ur^Br|, Xuc^Efs, Xuc^Efs, Xuc, Xuc, Xuc, Xuc, Xuc, Xuc, Xuc, Xuc, Xuc, Xuc, Xuc, Xuc, Xuc, Xuc, Xuc
Xuc, Xuc, Xuc, Xuc, Xuc, Xuc, Xuc, Xuc, Xuc, Xuc, Xuc, Xuc, Xuc, Xuc, Xuc, Xuc, Xuc, Xuc, Xuc, Xuc, Xuc, Xuc, Xuc, Xuc, Xuc, Xuc, Xuc, Xuc, Xuc, Xuc^Efs, Ur, Xuc^Efs, Ur^Br/, Ur, Ur^Br/, Ur, Ur^Br/, Ur, Ur^Br/, Ur, Ur^Br|, Xuc^Efs, Ur^Br/, Xuc^Efs, Xuc, Xuc, Xuc, Xuc, Xuc, Xuc, Xuc, Xuc, Xuc, Xuc, Xuc, Xuc, Xuc, Xuc
Xuc, Xuc, Xuc, Xuc, Xuc, Xuc, Xuc, Xuc, Xuc, Xuc, Xuc, Xuc, Xuc, Xuc, Xuc, Xuc, Xuc, Xuc, Xuc, Xuc, Xuc, Xuc, Xuc, Xuc, Xuc, Xuc, Xuc, Xuc, Xuc, Xuc^Efs, Ur^Br/, Ur^Br/, Ur, Ur^Br\, Ur, Ur^Br\, Ur, Ur^Br\, Ur, Ur^Br\, Ur^Br|, Ur^Br\, Ur, Xuc^Efs, Xuc, Xuc, Xuc, Xuc, Xuc, Xuc, Xuc, Xuc, Xuc, Xuc, Xuc, Xuc, Xuc, Xuc
Xuc, Xuc, Xuc, Xuc, Xuc, Xuc, Xuc, Xuc, Xuc, Xuc, Xuc, Xuc, Xuc, Xuc, Xuc, Xuc, Xuc, Xuc, Xuc, Xuc, Xuc, Xuc, Xuc, Xuc, Xuc, Xuc, Xuc, Xuc, Xuc, Xuc^Efs, Ur^Br|, Xuc^Efs, Xuc^Efs, Xuc^Efs, Xuc^Efs, Xuc^Efs, Xuc^Efs, Xuc^Efs, Xuc^Efs, Ur, Ur^Br|, Xuc^Efs, Xuc^Efs, Xuc^Efs, Xuc, Xuc, Xuc, Xuc, Xuc, Xuc, Xuc, Xuc, Xuc, Xuc, Xuc, Xuc, Xuc, Xuc
Xuc, Xuc, Xuc, Xuc, Xuc, Xuc, Xuc, Xuc, Xuc, Xuc, Xuc, Xuc, Xuc, Xuc, Xuc, Xuc, Xuc, Xuc, Xuc, Xuc, Xuc, Xuc, Xuc, Xuc, Xuc, Xuc, Xuc^Efs, Xuc^Efs, Xuc^Efs, Xuc^Efs, Ur^Br|, Xuc^Efs, Xuc^Efs, Xuc, Xuc, Xuc, Xuc, Xuc, Xuc^Efs, Ur, Ur^Br|, Xuc, Ur, Xuc, Xuc, Xuc, Xuc, Xuc, Xuc, Xuc, Xuc, Xuc, Xuc, Xuc, Xuc, Xuc, Xuc, Xuc
Xuc, Xuc, Xuc, Xuc, Xuc, Xuc, Xuc, Xuc, Xuc, Xuc, Xuc, Xuc, Xuc, Xuc, Xuc, Xuc, Xuc, Xuc, Xuc, Xuc, Xuc, Xuc, Xu, Xuc, Xuc, Xuc, Xuc^Efs, Ur, Ur, Ur, Ur^Br|, Ur, Xuc^Efs, Xuc, Xuc^Efs, Xuc, Xuc, Xuc, Xuc^Efs, Ur, Ur^Br|, Xuc, Ur, Xuc, Xuc, Xuc, Xuc, Xuc, Xuc, Xuc, Xuc, Xuc, Xuc, Xuc, Xuc, Xuc, Xuc, Xuc
Xuc, Xuc, Xuc, Xuc, Xuc, Xuc, Xuc, Xuc, Xuc, Xuc, Xuc, Xuc, Xuc, Xuc, Xuc, Xuc, Xuc, Xuc, Xuc, Xuc, Xu, Xu, Uu, Xu, Xu, Xuc, Xuc^Efs, Ur, Ur, Ur^Br/, Ur^Br|, Ur, Xuc^Efs, Xuc^Efs, Ur, Xuc^Efs, Xuc, Xuc, Xuc^Efs, Ur, Ur^Br|, Xuc^Efs, Xuc^Efs, Xuc, Xuc^Efs, Xuc, Xuc, Xuc, Xuc, Xuc, Xuc, Xuc, Xuc, Xuc, Xuc, Xuc, Xuc, Xuc
Xuc, Xuc, Xuc, Xuc, Xuc, Xuc, Xuc, Xuc, Xuc, Xuc, Xuc, Xuc, Xuc, Xuc, Xuc, Xuc, Xuc, Xuc, Xuc, Xu, Uu, Uu, Xu, Uu, Uu, Xu, Xuc^Efs, Ur, Ur, Ur^Br|, Ur^Br|, Ur, Ur, Xuc^Efs, Ur, Xuc^Efs, Xuc^Efs, Xuc, Xuc^Efs, Ur, Ur^Br\, Xuc^Efs, Ur, Xuc^Efs, Ur, Xuc^Efs, Xuc^Efs, Xuc, Xuc, Xuc, Xuc, Xuc, Xuc, Xuc, Xuc, Xuc, Xuc, Xuc
Xuc, Xuc, Xuc, Xuc, Xuc, Xuc, Xuc, Xuc, Xuc, Xuc, Xuc, Xuc, Xuc, Xuc, Xuc, Xuc, Xuc, Xuc, Xu, Xu, Uu, Uu, Xu, Uu, Uu, Xuc^Efs, Ur, Ur, Ur, Ur^Br|, Ur^Br|, Ur, Ur, Ur, Ur, Ur, Xuc^Efs, Xuc, Xuc, Xuc^Efs, Ur, Ur^Br\, Ur^Br\, Ur^Br/, Ur^Br\, Ur, Xuc^Efs, Xuc, Xuc, Xuc, Xuc, Xuc, Xuc, Xuc, Xuc, Xuc, Xuc, Xuc
Xuc, Xuc, Xuc, Xuc, Xuc, Xuc, Xuc, Xuc, Xuc, Xuc, Xuc, Xuc, Xuc, Xuc, Xuc, Xuc, Xuc, Xuc, Xu, Uu, Uu, Xu, Uu, Uu, Uu, Xuc^Efs, Ur, Ur, Ur, Ur^Br|, Ur^Br|, Ur, Xuc^Efs, Xuc^Efs, Xuc^Efs, Xuc^Efs, Xuc, Xuc, Xuc, Xuc^Efs, Xuc^Efs, Ur, Xuc^Efs, Ur, Xuc^Efs, Ur^Br\, Ur, Xuc^Efs, Xuc, Xuc, Xuc, Xuc, Xuc, Xuc, Xuc, Xuc, Xuc, Xuc
Xuc, Xuc, Xuc, Xuc, Xuc, Xuc, Xuc, Xuc, Xuc, Xuc, Xuc, Xuc, Xuc, Xuc, Xuc, Xuc, Xuc, Xuc, Xuc, Xu, Uu, Xu, Uu, Uu, Uu, Xuc^Efs, Ur, Ur, Ur, Ur^Br|, Ur, Ur, Xuc^Efs, Xuc, Xuc, Xuc, Xuc, Xuc, Xuc, Xuc, Xuc^Efs, Xuc^Efs, Xuc^Efs, Xuc^Efs, Xuc^Efs, Ur^Br|, Ur, Xuc^Efs, Xuc, Xuc, Xuc, Xuc, Xuc, Xuc, Xuc, Xuc, Xuc, Xuc
Xuc, Xuc, Xuc, Xuc, Xuc, Xuc, Xuc, Xuc, Xuc, Xuc, Xuc, Xuc, Xuc, Xuc, Xuc, Xuc, Xuc, Xuc, Xuc, Xu, Xu, Uu, Uu, Xu, Xu, Xuc^Efs, Xuc^Efs, Xuc^Efs, Xuc^Efs, Ur^Br|, Xuc^Efs, Xuc^Efs, Xuc, Xuc, Xuc, Xuc, Xuc, Xuc, Xuc^Efs, Xuc^Efs, Ur, Ur, Ur, Xuc^Efs, Ur, Ur^Br|, Ur, Xuc^Efs, Xuc^Efs, Xuc, Xuc, Xuc, Xuc, Xuc, Xuc, Xuc, Xuc, Xuc
Xuc, Xuc, Xuc, Xuc, Xuc, Xuc, Xuc, Xuc, Xuc, Xuc, Xuc, Xuc, Xuc, Xuc, Xuc, Xuc, Xuc, Xuc, Xuc, Xu, Uu, Uu, Uu, Xu, Uu, Xu, Xu, Xuc, Xuc^Efs, Ur^Br|, Ur, Xuc^Efs, Xu, Xu, Xu, Xuc, Xuc, Xuc, Xuc^Efs, Ur, Ur, Ur, Ur, Ur, Ur, Ur^Br|, Ur, Ur, Xuc^Efs, Xuc, Xuc, Xuc, Xuc, Xuc, Xuc, Xuc, Xuc, Xuc
Xuc, Xuc, Xuc, Xuc, Xuc, Xuc, Xuc, Xuc, Xuc, Xuc, Xuc, Xuc, Xuc^Efs, Xuc, Xuc, Xuc, Xuc, Xuc, Xuc, Xuc, Xuc^Efs, Xu, Xu, Xu, Uu, Uu, Xu, Xuc, Xuc^Efs, Ur^Br|, Ur, Xuc^Efs, Uu, Uu, Xu, Xuc, Xuc, Xuc, Xuc^Efs, Ur, Ur, Ur, Ur, Ur, Ur, Ur^Br|, Ur, Ur, Ur^Dr, Xuc, Xuc^Efs, Xuc, Xuc, Xuc, Xuc, Xuc, Xuc, Xuc
Xuc, Xuc, Xuc, Xuc, Xuc, Xuc, Xuc, Xuc, Xuc, Xuc, Xuc^Efs, Xuc^Efs, Ur, Xuc^Efs, Xuc^Efs, Xuc, Xuc, Xuc, Xuc^Efs, Xuc^Efs, Ur, Xuc^Efs, Xu, Uu, Uu, Uu, Uu, Xu, Xuc^Efs, Ur^Br|, Ur, Xuc^Efs, Uu, Uu, Xu, Xuc, Xuc, Xuc, Xuc^Efs, Ur, Ur, Ur, Ur, Ur, Ur^Br/, Ur^Br|, Ur^Br\, Ur, Ur^Br/, Xuc^Efs, Ur, Xuc^Efs, Xuc^Efs, Xuc, Xuc^Efs, Xuc^Efs, Xuc^Efs, Xuc
Xuc, Xuc, Xuc, Xuc, Xuc, Xuc, Xuc, Xuc, Xuc, Xuc, Xuc^Efs, Ur, Ior, Ior, Xuc^Efs, Xuc, Xuc, Xuc, Xuc^Efs, Ur^Br|, Ur, Xuc^Efs, Xuc, Xu, Xu, Uu, Uu, Xu, Xuc^Efs, Ur^Br|, Ur, Xuc^Efs, Xu, Uu, Xu, Xuc, Xuc, Xuc^Efs, Ur^Br\, Ur, Ur^Br/, Ur, Ur^Br/, Ur^Br\, Ur^Br/, Ur^Br/, Ur^Br/, Ur^Br/, Ur^Br\, Ur^Br\, Ur^Br\, Xuc^Efs, Ur^Br/, Xuc^Efs, Cud, Cud, Ur^Br/, Xuc^Efs
Xuc, Xuc, Xuc, Xuc, Xuc, Xuc, Xuc^Efs, Xuc^Efs, Xuc^Efs, Xuc^Efs, Ur, Ur, Ur, Ior, Ur, Xuc^Efs, Xuc^Efs, Xuc^Efs, Xuc^Efs, Ur^Br\, Ur^Br|, Xuc^Efs, Xuc^Efs, Xuc^Efs, Xuc^Efs, Xuc^Efs, Xuc^Efs, Xuc^Efs, Xuc^Efs, Ur^Br|, Ur, Xuc^Efs, Xuc, Xu, Xuc, Xuc, Xuc, Xuc^Efs, Xuc^Efs, Ur^Br\, Ur, Ur^Br\, Ur^Br/, Ur^Br\, Ur^Br/, Ur^Br/, Ur^Br/, Ur^Br/, Ur, Ur^Br/, Ur, Ur^Br/, Ur, Ur^Br\, Cud, Kud, Ur, Ur^Br\
Xuc, Xuc, Xuc, Xuc, Xuc^Efs, Xuc^Efs, Ur, Ur, Ur, Ur, Ur, Ur, Ur^Br/, Ur, Ur^Br/, Ur, Ur^Br/, Ur, Ur^Br/, Ur, Ur^Br/, Ur, Ur^Br/, Ur, Ur^Br/, Ur, Ur^Br/, Ur, Ur^Br/, Ur^Br/, Xuc^Efs, Xuc^Efs, Xuc, Xuc, Xuc, Xuc, Xuc, Xuc, Xuc, Xuc^Efs, Ur, Ur^Br/, Ur, Ur^Br\, Ur^Br/, Ur^Br/, Ur, Ur, Xuc^Efs, Xuc^Efs, Xuc^Efs, Xuc^Efs, Xuc^Efs, Xuc^Efs, Xuc^Efs, Cud, Xuc^Efs, Xuc^Efs
Xuc, Xuc, Xuc, Xuc, Xuc^Efs, Ur, Ur, Ur, Ur, Ur, Ur, Ur^Br/, Ur, Ur^Br\, Ur, Ur^Br\, Xuc^Efs, Ur^Br\, Xuc^Efs, Ur^Br\, Xuc^Efs, Ur^Br\, Xuc^Efs, Ur^Br\, Xuc^Efs, Ur^Br\, Xuc^Efs, Ur^Br\, Xuc^Efs, Xuc^Efs, Xuc, Xuc, Xuc, Xuc, Xuc, Xuc, Xuc, Xuc, Xuc, Xuc^Efs, Xuc^Efs, Ur, Xuc^Efs, Ur, Ur^Br|, Ur, Xuc^Efs, Xuc^Efs, Xuc, Xuc, Xuc, Xuc, Xuc, Xuc, Xuc, Xuc^Efs, Xuc, Xuc
Xuc, Xuc, Xuc, Xuc, Xuc^Efs, Ur, Xuc^Efs, Ur, Xuc^Efs, Xuc^Efs, Ur, Ur, Ior, Ur, Ur, Xuc^Efs, Xuc, Xuc^Efs, Xuc, Xuc^Efs, Xuc, Xuc^Efs, Xuc, Xuc^Efs, Xuc, Xuc^Efs, Xuc, Xuc^Efs, Xuc, Xuc, Xuc, Xuc, Xuc, Xuc, Xuc, Xuc, Xuc, Xuc, Xuc, Xuc, Xuc, Xuc^Efs, Xuc, Xuc^Efs, Ur^Br|, Ur, Xuc^Efs, Xuc, Xuc, Xuc, Xuc, Xuc, Xuc, Xuc, Xuc, Xuc, Xuc, Xuc
Xuc, Xuc, Xuc, Xuc, Xuc, Xuc^Efs, Xuc, Xuc^Efs, Xuc, Xuc^Efs, Xuc^Efs, Ur, Ior, Ior, Ur, Xuc^Efs, Xuc, Xuc, Xuc, Xuc, Xuc, Xuc, Xuc, Xuc, Xuc, Xuc, Xuc, Xuc, Xuc, Xuc, Xuc, Xuc, Xuc, Xuc, Xuc, Xuc, Xuc, Xuc, Xuc, Xuc, Xuc, Xuc, Xuc, Xuc^Efs, Ur^Br|, Ur, Xuc^Efs, Xuc, Xuc, Xuc, Xuc, Xuc, Xuc, Xuc, Xuc, Xuc, Xuc, Xuc
Xuc, Xuc, Xuc, Xuc, Xuc, Xuc, Xuc, Xuc, Xuc, Xuc, Xuc, Xuc^Efs, Xuc^Efs, Ur, Xuc^Efs, Xuc^Efs, Xuc, Xuc, Xuc, Xuc, Xuc, Xuc, Xuc, Xuc, Xuc, Xuc, Xuc, Xuc, Xuc, Xuc, Xuc, Xuc, Xuc, Xuc, Xuc, Xuc, Xuc, Xuc, Xuc, Xuc, Xuc, Xuc, Xuc, Xuc^Efs, Ur^Br|, Ur, Xuc^Efs, Xuc, Xuc, Xuc, Xuc, Xuc, Xuc, Xuc, Xuc, Xuc, Xuc, Xuc
Xuc, Xuc, Xuc, Xuc, Xuc, Xuc, Xuc, Xuc, Xuc, Xuc, Xuc, Xuc, Xuc, Xuc^Efs, Xuc, Xuc, Xuc, Xuc, Xuc, Xuc, Xuc, Xuc, Xuc, Xuc, Xuc, Xuc, Xuc, Xuc, Xuc, Xuc, Xuc, Xuc, Xuc, Xuc, Xuc^Efs, Xuc, Xuc^Efs, Xuc, Xuc^Efs, Xuc, Xuc^Efs, Xuc, Xuc^Efs, Xuc^Efs, Ur^Br|, Ur, Xuc^Efs, Xuc, Xuc, Xuc, Xuc, Xuc, Xuc, Xuc, Xuc, Xuc, Xuc, Xuc
Xuc, Xuc, Xuc, Xuc, Xuc, Xuc, Xuc, Xuc, Xuc, Xuc, Xuc, Xuc, Xuc, Xuc, Xuc, Xuc, Xuc, Xuc, Xuc, Xuc, Xuc, Xuc, Xuc, Xuc, Xuc, Xuc, Xuc, Xuc, Xuc, Xuc, Xuc, Xuc, Xuc, Xuc^Efs, Ur, Xuc^Efs, Ur, Xuc^Efs, Ur, Xuc^Efs, Ur, Xuc^Efs, Ur, Xuc^Efs, Ur^Br/, Ur, Xuc^Efs, Xuc, Xuc, Xuc, Xuc, Xuc, Xuc, Xuc, Xuc, Xuc, Xuc, Xuc
Xuc, Xuc, Xuc, Xuc, Xuc, Xuc, Xuc, Xuc, Xuc, Xuc, Xuc, Xuc, Xuc, Xuc, Xuc, Xuc, Xuc, Xuc, Xuc, Xuc, Xuc, Xuc, Xuc, Xuc, Xuc, Xuc, Xuc, Xuc, Xuc, Xuc, Xuc, Xuc, Xuc, Xuc^Efs, Ur^Br/, Ur^Br/, Ur^Br\, Ur^Br/, Ur^Br\, Ur^Br/, Ur^Br\, Ur^Br/, Ur^Br\, Ur^Br/, Ur, Xuc^Efs, Xuc, Xuc, Xuc, Xuc, Xuc, Xuc, Xuc, Xuc, Xuc, Xuc, Xuc, Xuc
Xuc, Xuc, Xuc, Xuc, Xuc, Xuc, Xuc, Xuc, Xuc, Xuc, Xuc, Xuc, Xuc, Xuc, Xuc, Xuc, Xuc, Xuc, Xuc, Xuc, Xuc, Xuc, Xuc, Xuc, Xuc, Xuc, Xuc, Xuc, Xuc, Xuc, Xuc, Xuc, Xuc, Xuc^Efs, Ur, Ur, Wwg, Ur, Ur, Ur, Ur, Ur, Xuc^Efs, Xuc^Efs, Xuc^Efs, Xuc^Efs, Xuc, Xuc, Xuc, Xuc, Xuc, Xuc, Xuc, Xuc, Xuc, Xuc, Xuc, Xuc
Xuc, Xuc, Xuc, Xuc, Xuc, Xuc, Xuc, Xuc, Xuc, Xuc, Xuc, Xuc, Xuc, Xuc, Xuc, Xuc, Xuc, Xuc, Xuc, Xuc, Xuc, Xuc, Xuc, Xuc, Xuc, Xuc, Xuc, Xuc, Xuc, Xuc, Xuc, Xuc, Xu, Xuc^Efs, Ur, Ur, Wwg, Wwg, Wwg, Ur, Xuc, Xuc, Xu, Xuc, Xuc, Xuc, Xuc, Xuc, Xuc, Xuc, Xuc, Xuc, Xuc, Xuc, Xuc, Xuc, Xuc, Xuc
Xuc, Xuc, Xuc, Xuc, Xuc, Xuc, Xuc, Xuc, Xuc, Xuc, Xuc, Xuc, Xuc, Xuc, Xuc, Xuc, Xuc, Xuc, Xuc, Xuc, Xuc, Xuc, Xuc, Xuc, Xuc, Xuc, Xuc, Xuc, Xuc, Xuc, Xu, Xu, Wwg, Wwg, Wwg, Wwg, Wwg, Wwg, Wwg, Wwg, Wwg, Wwg, Xu, Xuc, Xuc, Xuc, Xuc, Xuc, Xuc, Xuc, Xuc, Xuc, Xuc, Xuc, Xuc, Xuc, Xuc, Xuc
Xuc, Xuc, Xuc, Xuc, Xuc, Xuc, Xuc, Xuc, Xuc, Xuc, Xuc, Xuc, Xuc, Xuc, Xuc, Xuc, Xuc, Xuc, Xuc, Xuc, Xuc, Xuc, Xuc, Xuc, Xuc, Xuc, Xuc, Xuc, Xuc, Xuc, Xu, Wwg, Xu, Xu, Xu, Wwg, Xu, Xu, Xu, Wwg, Wwg, Wwg, Wwg, Xu, Xu, Xuc, Xuc, Xuc, Xuc, Xuc, Xuc, Xuc, Xuc, Xuc, Xuc, Xuc, Xuc, Xuc
Xuc, Xuc, Xuc, Xuc, Xuc, Xuc, Xuc, Xuc, Xuc, Xuc, Xuc, Xuc, Xuc, Xuc, Xuc, Xuc, Xuc, Xuc, Xuc, Xuc, Xuc, Xuc, Xuc, Xuc, Xuc, Xuc, Xuc, Xuc, Xuc, Xu, Wwg, Wwg, Xu, Xu, Wwg, Wwg, Wwg, Xu, Xu, Wwg, Xu, Xu, Xu, Wwg, Wwg, Xu, Xu, Xuc, Xuc, Xuc, Xuc, Xuc, Xuc, Xuc, Xuc, Xuc, Xuc, Xuc
Xuc, Xuc, Xuc, Xuc, Xuc, Xuc, Xuc, Xuc, Xuc, Xuc, Xuc, Xuc, Xuc, Xuc, Xuc, Xuc, Xuc, Xuc, Xuc, Xuc, Xuc, Xuc, Xuc, Xuc, Xuc, Xuc, Xuc, Xuc, Xuc, Xu, Xu, Wwg, Xu, Xu, Xu, Wwg, Xu, Wwg, Wwg, Wwg, Wwg, Xu, Xuc, Xu, Xu, Wwg, Xu, Xuc, Xuc, Xuc, Xuc, Xuc, Xuc, Xuc, Xuc, Xuc, Xuc, Xuc
Xuc, Xuc, Xuc, Xuc, Xuc, Xuc, Xuc, Xuc, Xuc, Xuc, Xuc, Xuc, Xuc, Xuc, Xuc, Xuc, Xuc, Xuc, Xuc, Xuc, Xuc, Xuc, Xuc, Xuc, Xuc, Xuc, Xuc, Xuc, Xuc, Xuc, Xu, Wwg, Xu, Xu, Xu, Wwg, Xu, Xu, Xu, Wwg, Wwg, Xu, Xuc, Xuc, Xuc, Xu, Xuc, Xuc, Xuc, Xuc, Xuc, Xuc, Xuc, Xuc, Xuc, Xuc, Xuc, Xuc
Xuc, Xuc, Xuc, Xuc, Xuc, Xuc, Xuc, Xuc, Xuc, Xuc, Xuc, Xuc, Xuc, Xuc, Xuc, Xuc, Xuc, Xuc, Xuc, Xuc, Xuc, Xuc, Xuc, Xuc, Xuc, Xuc, Xuc, Xuc, Xuc, Xu, Wwg, Wwg, Wwg, Wwg, Xu, Xu, Xuc, Xuc, Xuc, Xu, Xu, Xu, Xuc, Xuc, Xuc, Xuc, Xuc, Xuc, Xuc, Xuc, Xuc, Xuc, Xuc, Xuc, Xuc, Xuc, Xuc, Xuc
Xuc, Xuc, Xuc, Xuc, Xuc, Xuc, Xuc, Xuc, Xuc, Xuc, Xuc, Xuc, Xuc, Xuc, Xuc, Xuc, Xuc, Xuc, Xuc, Xuc, Xuc, Xuc, Xuc, Xuc, Xuc, Xuc, Xuc, Xuc, Xuc, Xu, Xu, Wwg, Wwg, Xu, Xu, Xuc, Xuc, Xuc, Xuc, Xuc, Xuc, Xuc, Xuc, Xuc, Xuc, Xuc, Xuc, Xuc, Xuc, Xuc, Xuc, Xuc, Xuc, Xuc, Xuc, Xuc, Xuc, Xuc
Xuc, Xuc, Xuc, Xuc, Xuc, Xuc, Xuc, Xuc, Xuc, Xuc, Xuc, Xuc, Xuc, Xuc, Xuc, Xuc, Xuc, Xuc, Xuc, Xuc, Xuc, Xuc, Xuc, Xuc, Xuc, Xuc, Xuc, Xuc, Xu, Xu, Wwg, Wwg, Uu, Wwg, Xu, Xuc, Xuc, Xuc, Xuc, Xuc, Xuc, Xuc, Xuc, Xuc, Xuc, Xuc, Xuc, Xuc, Xuc, Xuc, Xuc, Xuc, Xuc, Xuc, Xuc, Xuc, Xuc, Xuc
Xuc, Xuc, Xuc, Xuc, Xuc, Xuc, Xuc, Xuc, Xuc, Xuc, Xuc, Xuc, Xuc, Xuc, Xuc, Xuc, Xuc, Xuc, Xuc, Xuc, Xuc, Xuc, Xuc, Xuc, Xuc, Xuc, Xuc, Xuc, Xu, Uu, Uu, Wwg, Uu, Uu, Uu, Xu, Xuc, Xuc, Xuc, Xuc, Xuc, Xuc, Xuc, Xuc, Xuc, Xuc, Xuc, Xuc, Xuc, Xuc, Xuc, Xuc, Xuc, Xuc, Xuc, Xuc, Xuc, Xuc
Xuc, Xuc, Xuc, Xuc, Xuc, Xuc, Xuc, Xuc, Xuc, Xuc, Xuc, Xuc, Xuc, Xuc, Xuc, Xuc, Xuc, Xuc, Xuc, Xuc, Xuc, Xuc, Xuc, Xuc, Xuc, Xuc, Xuc, Xuc, Xu, Uu, Ce, Uu, Uu^Do, Uu, Xu, Xu, Xuc, Xuc, Xuc, Xuc, Xuc, Xuc, Xuc, Xuc, Xuc, Xuc, Xuc, Xuc, Xuc, Xuc, Xuc, Xuc, Xuc, Xuc, Xuc, Xuc, Xuc, Xuc
Xuc, Xuc, Xuc, Xuc, Xuc, Xuc, Xuc, Xuc, Xuc, Xuc, Xuc, Xuc, Xuc, Xuc, Xuc, Xuc, Xuc, Xuc, Xuc, Xuc, Xuc, Xuc, Xuc, Xuc, Xuc, Xuc, Xuc, Xuc, Xu, Uu, Ke, Ce, Uu, Uu, Xu, Xuc, Xuc, Xuc, Xuc, Xuc, Xuc, Xuc, Xuc, Xuc, Xuc, Xuc, Xuc, Xuc, Xuc, Xuc, Xuc, Xuc, Xuc, Xuc, Xuc, Xuc, Xuc, Xuc
Xuc, Xuc, Xuc, Xuc, Xuc, Xuc, Xuc, Xuc, Xuc, Xuc, Xuc, Xuc, Xuc, Xuc, Xuc, Xuc, Xuc, Xuc, Xuc, Xuc, Xuc, Xuc, Xuc, Xuc, Xuc, Xuc, Xuc, Xuc, Xuc, Xu, Xu, Uu, Xu, Xu, Xuc, Xuc, Xuc, Xuc, Xuc, Xuc, Xuc, Xuc, Xuc, Xuc, Xuc, Xuc, Xuc, Xuc, Xuc, Xuc, Xuc, Xuc, Xuc, Xuc, Xuc, Xuc, Xuc, Xuc
Xuc, Xuc, Xuc, Xuc, Xuc, Xuc, Xuc, Xuc, Xuc, Xuc, Xuc, Xuc, Xuc, Xuc, Xuc, Xuc, Xuc, Xuc, Xuc, Xuc, Xuc, Xuc, Xuc, Xuc, Xuc, Xuc, Xuc, Xuc, Xuc, Xuc, Xuc, Xu, Xuc, Xuc, Xuc, Xuc, Xuc, Xuc, Xuc, Xuc, Xuc, Xuc, Xuc, Xuc, Xuc, Xuc, Xuc, Xuc, Xuc, Xuc, Xuc, Xuc, Xuc, Xuc, Xuc, Xuc, Xuc, Xuc
Xuc, Xuc, Xuc, Xuc, Xuc, Xuc, Xuc, Xuc, Xuc, Xuc, Xuc, Xuc, Xuc, Xuc, Xuc, Xuc, Xuc, Xuc, Xuc, Xuc, Xuc, Xuc, Xuc, Xuc, Xuc, Xuc, Xuc, Xuc, Xuc, Xuc, Xuc, Xuc, Xuc, Xuc, Xuc, Xuc, Xuc, Xuc, Xuc, Xuc, Xuc, Xuc, Xuc, Xuc, Xuc, Xuc, Xuc, Xuc, Xuc, Xuc, Xuc, Xuc, Xuc, Xuc, Xuc, Xuc, Xuc, Xuc
