Xuc, Xuc, Xuc, Xuc, Xuc, Xuc, Xuc, Xuc, Xuc, Xuc, Xuc^Efs, Ur, Ur, Ur, Xuc^Efs, Xuc, Xuc^Efs, Xuc, Xuc, Xuc, Xuc, Xuc, Xuc, Xuc, Xuc, Xuc, Xuc, Xuc, Xuc, Xuc, Xuc, Xuc, Xuc, Xuc, Xuc, Xuc, Xuc, Xuc, Xuc, Xuc, Xuc, Xuc, Xuc, Xuc, Xuc, Xuc, Xuc, Xuc, Xuc, Xuc, Xuc, Xuc, Xuc, Xuc, Xuc, Xuc, Xuc, Xuc, Xuc
Xuc, Xuc, Xuc, Xuc, Xuc, Xuc, Xuc, Xuc, Xuc, Xuc, Xuc, Xuc^Efs, Xuc^Efs, Ur, Xuc^Efs, Xuc, Xuc^Efs, Xuc, Xuc, Xuc, Xuc, Xuc, Xuc, Xuc, Xuc, Xuc, Xuc, Xuc, Xuc, Xuc, Xuc, Xuc, Xuc, Xuc, Xuc, Xuc, Xuc, Xuc, Xuc, Xuc, Xuc, Xuc, Xuc, Xuc, Xuc, Xuc, Xuc, Xuc, Xuc, Xuc, Xuc, Xuc, Xuc, Xuc, Xuc, Xuc, Xuc, Xuc, Xuc
Xuc, Xuc, Xuc, Xuc, Xuc, Xuc, Xuc, Xuc, Xuc, Xuc, Xuc, Xuc^Efs, Ur, Ur, Xuc^Efs, Xuc^Efs, Ur, Xuc^Efs, Xuc, Xuc, Xuc, Xuc, Xuc, Xuc, Xuc, Xuc, Xuc, Xuc, Xuc, Xuc, Xuc, Xuc, Xuc, Xuc, Xuc, Xuc, Xuc, Xuc, Xuc, Xuc, Xuc, Xuc, Xuc, Xuc, Xuc, Xuc, Xuc, Xuc, Xuc, Xuc, Xuc, Xuc, Xuc, Xuc, Xuc, Xuc, Xuc, Xuc, Xuc
Xuc, Xuc, Xuc, Xuc, Xuc, Xuc, Xuc, Xuc, Xuc, Xuc, Xuc^Efs, Xuc^Efs, Ur, Ur, Xuc^Efs, Ur^Br|, Ur, Xuc^Efs, Xuc, Xuc, Xuc, Xuc, Xuc, Xuc, Xuc, Xuc, Xuc, Xuc, Xuc, Xuc, Xuc, Xuc, Xuc, Xuc, Xuc, Xuc, Xuc, Xuc, Xuc, Xuc, Xuc, Xuc, Xuc, Xuc, Xuc, Xuc, Xuc, Xuc, Xuc, Xuc, Xuc, Xuc, Xuc, Xuc, Xuc, Xuc, Xuc, Xuc, Xuc
Xuc, Xuc, Xuc, Xuc, Xuc, Xuc, Xuc, Xuc, Xuc, Xuc, Uu^Vud, Ur, Ior, Ior, Xuc^Efs, Ur^Br|, Ur, Xuc^Efs, Xuc, Xuc, Xuc, Xuc, Xuc, Xuc, Xuc, Xuc, Xuc, Xuc, Xuc, Xuc, Xuc, Xuc, Xuc, Xuc, Xuc, Xuc, Xuc, Xuc, Xuc, Xuc, Xuc, Xuc, Xuc, Xuc, Xuc, Xuc, Xuc, Xuc, Xuc, Xuc, Xuc, Xuc, Xuc, Xuc, Xuc, Xuc, Xuc, Xuc, Xuc
Xuc, Xuc, Xuc, Xuc, Xuc, Xuc, Xuc, Xuc, Xuc, Xuc, Xuc^Efs, Ur, Ur, Ior, Ur, Ur^Br|, Xuc^Efs, Xuc^Efs, Xuc, Xuc, Xuc, Xuc, Xuc, Xuc, Xuc, Xuc, Xuc, Xuc, Xuc, Xuc, Xuc, Xuc, Xuc, Xuc, Xuc, Xuc, Xuc, Xuc, Xuc, Xuc, Xuc, Xuc, Xuc, Xuc, Xuc, Xuc, Xuc, Xuc, Xuc, Xuc, Xuc, Xuc, Xuc, Xuc, Xuc, Xuc, Xuc, Xuc, Xuc
Xuc, Xuc, Xuc, Xuc, Xuc, Xuc, Xuc, Xuc, Xuc, Xuc, Xuc, Xuc^Efs, Ur, Ur, Xuc^Efs, Ur^Br|, Xuc^Efs, Xuc, Xuc, Xuc, Xuc, Xuc, Xuc, Xuc, Xuc, Xuc, Xuc, Xuc, Xuc, Xuc, Xuc, Xuc, Xuc^Efs, Xuc, Xuc, Xuc, Xuc, Xuc, Xuc, Xuc, Xuc, Xuc, Xuc, Xuc, Xuc, Xuc, Xuc, Xuc, Xuc, Xuc, Xuc, Xuc, Xuc, Xuc, Xuc, Xuc, Xuc, Xuc, Xuc
Xuc, Xuc, Xuc, Xuc, Xuc, Xuc, Xuc, Xuc, Xuc, Xuc, Xuc, Xuc^Efs, Xuc^Efs, Xuc^Efs, Xuc^Efs, Ur^Br|, Xuc^Efs, Xuc, Xuc, Xuc, Xuc, Xuc, Xuc, Xuc, Xuc, Xuc, Xuc, Xuc, Xuc^Efs, Xuc^Efs, Xuc^Efs, Xuc^Efs, Ur, Xuc^Efs, Xuc^Efs, Xuc, Xuc^Efs, Xuc, Xuc, Xuc, Xuc, Xuc, Xuc, Xuc, Xuc, Xuc, Xuc, Xuc, Xuc, Xuc, Xuc, Xuc, Xuc, Xuc, Xuc, Xuc, Xuc, Xuc, Xuc
Xuc, Xuc, Xuc, Xuc, Xuc, Xuc, Xuc, Xuc, Xuc, Xuc, Xuc, Xuc, Xuc, Xuc, Xuc^Efs, Ur^Br|, Xuc^Efs, Xuc, Xuc, Xuc, Xuc, Xuc, Xuc, Xuc, Xuc, Xuc, Xuc, Xuc^Efs, Ur, Ur, Ur, Ur, Ur, Ur, Xuc^Efs, Xuc^Efs, Ur, Xuc^Efs, Xuc, Xuc, Xuc, Xuc, Xuc, Xuc, Xuc, Xuc, Xuc, Xuc, Xuc, Xuc, Xuc, Xuc, Xuc, Xuc, Xuc, Xuc, Xuc, Xuc, Xuc
Xuc, Xuc, Xuc, Xuc, Xuc, Xuc, Xuc, Xuc, Xuc, Xuc, Xuc, Xuc, Xuc, Xuc, Xuc^Efs, Ur^Br|, Xuc^Efs, Xuc^Efs, Xuc^Efs, Xuc, Xuc^Efs, Xuc, Xuc, Xuc, Xuc, Xuc, Xuc, Xuc^Efs, Xuc^Efs, Xuc^Efs, Xuc^Efs, Ur, Ur, Xuc^Efs, Ur, Ur, Ur, Xuc^Efs, Xuc^Efs, Xuc, Xuc, Xuc, Xuc, Xuc, Xuc, Xuc, Xuc, Xuc, Xuc, Xuc, Xuc, Xuc, Xuc, Xuc, Xuc, Xuc, Xuc, Xuc, Xuc
Xuc, Xuc, Xuc, Xuc, Xuc, Xuc, Xuc, Xuc, Xuc, Xuc, Xuc, Xuc, Xuc, Xuc^Efs, Ur, Ur^Br|, Ur, Ur^Br|, Xuc^Efs, Xuc^Efs, Ur^Br|, Xuc^Efs, Xuc^Efs, Xuc^Efs, Xuc^Efs, Xuc^Efs, Xuc^Efs, Xuc^Efs, Xuc^Efs, Ur, Ur, Xuc^Efs, Xuc^Efs, Xuc^Efs, Uu^Vud, Ur, Ur, Ur, Xuc^Efs, Xuc, Xuc, Xuc, Xuc, Xuc, Xuc, Xuc, Xuc, Xuc, Xuc, Xuc, Xuc, Xuc, Xuc, Xuc, Xuc, Xuc, Xuc, Xuc, Xuc
Xuc, Xuc, Xuc, Xuc, Xuc, Xuc, Xuc, Xuc, Xuc, Xuc, Xuc, Xuc, Xuc, Xuc^Efs, Ur^Br\, Ur^Br|, Ur^Br\, Ur^Br|, Ur^Br\, Ur^Br/, Ur^Br|, Ur^Br/, Ur^Br\, Ur^Br/, Ur^Br\, Ur^Br/, Ur^Br\, Ur^Br/, Ur^Br\, Xuc^Efs, Ur^Br/, Ur^Br/, Ur^Br\, Ur^Br/, Ur^Br/, Ur^Br/, Ur^Br/, Ur^Br/, Xuc^Efs, Xuc, Xuc, Xuc, Xuc, Xuc, Xuc, Xuc, Xuc, Xuc, Xuc, Xuc, Xuc, Xuc, Xuc, Xuc, Xuc, Xuc, Xuc, Xuc, Xuc
Xuc, Xuc, Xuc, Xuc, Xuc, Xuc, Xuc, Xuc, Xuc, Xuc, Xuc, Xuc, Xuc, Xuc^Efs, Ur^Br/, Ur^Br|, Ur^Br/, Ur^Br|, Ur^Br/, Ur, Ur^Br|, Ur, Ur^Br/, Ur, Ur^Br/, Ur^Br\, Ur^Br/, Ur^Br/, Ur^Br\, Uu^Vud, Ur^Br/, Ur, Ur^Br/, Ur^Br/, Ur^Br/, Ur^Br\, Ur^Br/, Ur^Br\, Xuc^Efs, Xuc, Xuc, Xuc, Xuc, Xuc, Xuc, Xuc, Xuc, Xuc, Xuc, Xuc, Xuc, Xuc, Xuc, Xuc, Xuc, Xuc, Xuc, Xuc, Xuc
Xuc, Xuc, Xuc, Xuc, Xuc, Xuc, Xuc, Xuc, Xuc, Xuc, Xuc, Xuc, Xuc, Xuc^Efs, Ur, Ur^Br|, Ur, Ur^Br|, Xuc^Efs, Ur^Br\, Ur^Br|, Ur^Br\, Xuc^Efs, Ur^Br\, Xuc^Efs, Ur^Br\, Xuc^Efs, Ur^Br\, Xuc^Efs, Xuc^Efs, Ur, Ur^Br\, Xuc^Efs, Ur^Br\, Xuc^Efs, Ur^Br\, Xuc^Efs, Ur, Xuc^Efs, Xuc, Xuc, Xuc, Xuc, Xuc, Xuc, Xuc, Xuc, Xuc, Xuc, Xuc, Xuc, Xuc, Xuc, Xuc, Xuc, Xuc, Xuc, Xuc, Xuc
Xuc, Xuc, Xuc, Xuc, Xuc, Xuc, Xuc, Xuc, Xuc, Xuc, Xuc, Xuc, Xuc, Xuc^Efs, Xuc^Efs, Ur^Br\, Xuc^Efs, Xuc^Efs, Xuc, Xuc^Efs, Xuc^Efs, Xuc^Efs, Xuc, Xuc^Efs, Xuc, Xuc^Efs, Xuc, Xuc^Efs, Ur, Xuc^Efs, Xuc^Efs, Xuc^Efs, Ur, Xuc^Efs, Ur, Xuc^Efs, Ur, Xuc^Efs, Ur, Xuc^Efs, Xuc, Xuc, Xuc, Xuc, Xuc, Xuc, Xuc, Xuc, Xuc, Xuc, Xuc, Xuc, Xuc, Xuc, Xuc, Xuc, Xuc, Xuc, Xuc
Xuc, Xuc, Xuc, Xuc, Xuc, Xuc, Xuc, Xuc, Xuc, Xuc, Xoc^Efs, Xoc^Efs, Xoc^Efs, Xoc^Efs, Xoc^Efs, Ur^Pr|, Xoc^Efs, Xoc^Efs, Xoc^Efs, Xuc, Xuc, Xuc, Xuc, Xuc, Xuc, Xuc, Xuc, Xuc^Efs, Ur, Xuc^Efs, Ur, Ur, Xuc^Efs, Ur, Ur, Ur, Ur, Ur, Xuc^Efs, Xuc^Efs, Xuc, Xuc, Xuc, Xuc, Xuc, Xuc, Xuc, Xuc, Xuc, Xuc, Xuc, Xuc, Xuc, Xuc, Xuc, Xuc, Xuc, Xuc, Xuc
Xuc, Xuc, Xuc, Xuc, Xoc^Efs, Xoc^Efs, Xoc^Efs, Xuc, Xuc, Xuc, Xoc^Efs, Irs^Vud, Irs^Vud, Irs, Irs, Irs, Irs, Irs, Irs, Xoc^Efs, Xuc, Xuc, Xuc, Xuc, Xuc, Xuc, Xuc, Xuc^Efs, Xuc^Efs, Ur, Xuc^Efs, Xuc^Efs, Xuc, Xuc^Efs, Xuc^Efs, Xuc^Efs, Xuc^Efs, Ur, Ur, Xuc^Efs, Xuc, Xuc, Xuc, Xuc, Xuc, Xuc, Xuc, Xuc, Xuc, Xuc, Xuc, Xuc, Xuc, Xuc, Xuc, Xuc, Xuc, Xuc, Xuc
Xuc, Xuc, Xuc, Xoc^Efs, Irs, Irs, Wog, Xoc^Efs, Xuc, Xuc, Xoc^Efs, Irs, Irs^Ebn, Irs, Irs^Ebn, Irs, Irs, Irs, Irs, Xoc^Efs, Xuc, Xuc, Xuc, Xuc, Xuc, Xuc, Xuc, Xuc, Xuc, Xuc^Efs, Xuc, Xuc, Xuc, Xuc, Xuc, Xuc, Xuc^Efs, Ur, Xuc^Efs, Xuc^Efs, Xuc, Xuc, Xuc, Xuc, Xuc, Xuc, Xuc, Xuc, Xuc, Xuc, Xuc, Xuc, Xuc, Xuc, Xuc, Xuc, Xuc, Xuc, Xuc
Xuc, Xuc, Xuc, Xoc^Efs, Irs, Irs, Irs, Xoc^Efs, Xuc, Xuc, Xoc^Efs, Irs, Irs, Irs, Irs, Irs, Irs, Irs, Irs, Xoc^Efs, Xuc, Xuc, Xuc, Xuc, Xuc, Xuc, Xuc, Xuc, Xuc, Xuc, Xuc, Xuc, Xuc, Xuc, Xuc, Xuc^Efs, Ur, Ur, Ur, Xuc^Efs, Xuc^Efs, Xuc, Xuc, Xuc, Xuc, Xuc, Xuc, Xuc, Xuc, Xuc, Xuc, Xuc, Xuc, Xuc, Xuc, Xuc, Xuc, Xuc, Xuc
Xuc, Xuc, Xuc, Xoc^Efs, Irs, Irs, Wog, Xoc^Efs, Xuc, Xuc, Xoc^Ecf, Irs, Irs^Ebn, Irs, Irs^Ebn, Irs, Irs, Irs, Irs, Xoc^Efs, Xuc, Xuc, Xuc, Xuc, Xuc, Xuc, Xuc, Xuc, Xuc, Xuc, Xuc, Xuc, Xuc, Xuc, Xuc, Xuc^Efs, Xuc^Efs, Ur, Ur, Ur, Ur, Xuc^Efs, Xuc^Efs, Xuc, Xuc, Xuc, Xuc, Xuc, Xuc, Xuc, Xuc, Xuc, Xuc, Xuc, Xuc, Xuc, Xuc, Xuc, Xuc
Xuc, Xuc, Xuc, Xoc^Efs, Irs, Irs, Irs, Xoc^Efs, Xoc^Efs, Xoc^Efs, Xoc^Efs, Irs, Irs, Irs, Irs, Irs, Irs, Irs, Irs, Xoc^Efs, Xuc, Xuc, Xuc, Xuc, Xuc, Xuc, Xuc, Xuc, Xuc, Xuc, Xuc, Xuc, Xuc, Xuc, Xuc, Xuc, Xuc^Efs, Ur, Ur, Ur, Ur, Xuc^Efs, Cer, Xuc^Efs, Xuc^Efs, Xuc, Xuc, Xuc, Xuc, Xuc, Xuc, Xuc, Xuc, Xuc, Xuc, Xuc, Xuc, Xuc, Xuc
Xuc, Xuc, Xuc, Xoc^Efs, Irs, Irs, Irs, Xoc^Efs, Irs^Pr\, Irs, Irs, Irs, Irs, Irs, Irs, Irs, Irs, Irs, Irs, Xoc^Efs, Xuc, Xuc, Xuc, Xuc, Xuc, Xuc, Xuc, Xuc, Xuc, Xuc, Xuc, Xuc, Xuc, Xuc, Xuc, Xuc, Xuc^Efs, Ur, Xuc^Efs, Ur, Ur, Ur, Xuc^Efs, Ker, Xuc^Efs, Xuc, Xuc, Xuc, Xuc, Xuc, Xuc, Xuc, Xuc, Xuc, Xuc, Xuc, Xuc, Xuc, Xuc
Xuc, Xuc, Xuc, Xoc^Efs, Irs, Irs, Irs, Irs, Xoc^Efs, Xoc^Efs, Irs, Irs, Irs, Irs, Irs, Irs, Irs, Irs, Xoc^Efs, Xoc^Efs, Xuc, Xuc, Xuc, Xuc, Xuc, Xuc, Xuc, Xuc, Xuc, Xuc, Xuc, Xuc, Xuc, Xuc, Xuc, Xuc, Xuc^Efs, Ur, Xuc^Efs, Xuc^Efs, Ur, Xuc^Efs, Xuc^Efs, Cer, Xuc^Efs, Xuc, Xuc, Xuc, Xuc, Xuc, Xuc, Xuc, Xuc, Xuc, Xuc, Xuc, Xuc, Xuc, Xuc
Xuc, Xuc, Xuc, Xoc^Efs, Irs, Irs, Irs, Xoc^Efs, Xuc, Xuc^Efs, Xuc^Efs, Xoc^Efs, Xoc^Efs, Xoc^Efs, Irs^Pr|, Irs, Xoc^Efs, Xoc^Efs, Xuc, Xuc, Xuc, Xuc, Xuc, Xuc, Xuc, Xuc, Xuc, Xuc, Xuc, Xuc, Xuc, Xuc, Xuc, Xuc, Xuc, Xuc^Efs, Ur, Ur, Ur, Ur, Ur, Ur, Xuc^Efs, Ur, Ur, Xuc^Efs, Xuc, Xuc, Xuc, Xuc, Xuc, Xuc, Xuc, Xuc, Xuc, Xuc, Xuc, Xuc, Xuc
Xuc, Xuc, Xuc, Xoc^Efs, Xoc^Efs, Xoc^Efs, Xoc^Efs, Xoc^Efs, Xuc, Xuc, Xoc^Efs, Xoc^Efs, Xoc^Efs, Xoc^Efs, Irs, Xoc^Efs, Xoc^Efs, Xuc, Xuc, Xuc, Xuc, Xuc, Xuc, Xuc, Xuc, Xuc, Xuc, Xuc, Xuc, Xuc, Xuc, Xuc, Xuc, Xuc, Xuc, Xuc^Efs, Ur, Ur, Xuc^Efs, Ur, Ur, Wwg, Xuc^Efs, Xuc^Efs, Xuc^Efs, Xuc^Efs, Xuc, Xuc, Xuc, Xuc, Xuc, Xuc, Xuc, Xuc, Xuc, Xuc, Xuc, Xuc, Xuc
Xuc, Xuc, Xuc, Xuc, Xuc, Xuc, Xuc, Xuc, Xuc, Xuc, Xoc^Efs, Irs, Irs, Irs, Irs, Irs, Xoc^Efs, Xuc, Xuc, Xuc, Xuc, Xuc, Xuc, Xuc, Xuc, Xuc, Xuc, Xuc, Xuc, Xuc, Xuc, Xuc, Xuc, Xuc, Xuc, Xuc^Efs, Xuc^Efs, Ur, Ur, Xuc^Efs, Xuc^Efs, Wwg, Wwg, Wwg, Wwg, Xuc^Efs, Xuc^Efs, Xuc, Xuc, Xuc, Xuc, Xuc, Xuc, Xuc, Xuc, Xuc, Xuc, Xuc, Xuc
Xuc, Xuc, Xuc, Xuc, Xuc, Xuc, Xuc, Xuc, Xuc, Xuc, Xoc^Efs, Irs, Irs, Irs, Irs, Irs, Xoc^Efs, Xuc, Xuc, Xuc, Xuc, Xuc, Xuc, Xuc, Xuc, Xuc, Xuc, Xuc, Xuc, Xuc, Xuc, Xuc, Xuc, Xuc, Xuc, Xuc, Xuc, Xuc^Efs, Xuc^Efs, Xuc^Efs, Wwg, Wwg, Ur, Wwg, Wwg, Wwg, Xuc^Efs, Xuc, Xuc, Xuc, Xuc, Xuc, Xuc, Xuc, Xuc, Xuc, Xuc, Xuc, Xuc
Xuc, Xuc, Xuc, Xuc, Xuc, Xuc, Xuc, Xuc, Xuc, Xuc, Xoc^Efs, Irs, Xoc^Ecf, Irs, Xoc^Ecf, Irs, Xoc^Efs, Xuc, Xuc, Xuc, Xuc, Xuc, Xuc, Xuc, Xuc, Xuc, Xuc, Xuc, Xuc, Xuc, Xuc, Xuc, Xuc, Xuc, Xuc, Xuc, Xuc, Xuc, Xuc, Xuc^Efs, Wwg, Ur, Ur, Ur, Wwg, Xuc^Efs, Xuc, Xuc, Xuc, Xuc, Xuc, Xuc, Xuc, Xuc, Xuc, Xuc, Xuc, Xuc, Xuc
Xuc, Xuc, Xuc, Xuc, Xuc, Xuc, Xuc, Xuc, Xuc, Xuc, Xuc, Xoc^Efs, Xuc, Xoc, Xuc, Xoc^Efs, Xuc, Xuc, Xuc, Xuc, Xuc, Xuc, Xuc, Xuc, Xuc, Xuc, Xuc, Xuc, Xuc, Xuc, Xuc, Xuc, Xuc, Xuc, Xuc, Xuc, Xuc, Xuc, Xuc, Xuc^Efs, Wwg, Ur, Ur, Ur, Wwg, Xuc^Efs, Xuc, Xuc, Xuc, Xuc, Xuc, Xuc, Xuc, Xuc, Xuc, Xuc, Xuc, Xuc, Xuc
Xuc, Xuc, Xuc, Xuc, Xuc, Xuc, Xuc, Xuc, Xuc, Xuc, Xuc, Xuc, Xuc, Xuc, Xuc, Xuc, Xuc, Xuc, Xuc, Xuc, Xuc, Xuc, Xuc, Xuc, Xuc, Xuc, Xuc, Xuc, Xuc, Xuc, Xuc, Xuc, Xuc, Xuc, Xuc, Xuc, Xuc, Xuc, Xuc, Xuc^Efs, Wwg, Wwg, Ur, Wwg, Xuc^Efs, Xuc^Efs, Xuc^Efs, Xuc, Xuc, Xuc, Xuc, Xuc, Xuc, Xuc, Xuc, Xuc, Xuc, Xuc, Xuc
Xuc, Xuc, Xuc, Xuc, Xuc, Xuc, Xuc, Xuc, Xuc, Xuc, Xuc, Xuc, Xuc, Xuc, Xuc, Xuc, Xuc, Xuc, Xuc, Xuc, Xuc, Xuc, Xuc, Xuc, Xuc, Xuc, Xuc, Xuc, Xuc, Xuc, Xuc, Xuc, Xuc, Xuc, Xuc, Xuc, Xuc, Xuc, Xuc, Xuc^Efs, Xuc^Efs, Wwg, Wwg, Wwg, Wwg, Xuc^Efs, Ur, Xuc^Efs, Xuc, Xuc, Xuc, Xuc, Xuc, Xuc, Xuc, Xuc, Xuc, Xuc, Xuc
Xuc, Xuc, Xuc, Xuc, Xuc, Xuc, Xuc, Xuc, Xuc, Xuc, Xuc, Xuc, Xuc, Xuc, Xuc, Xuc, Xuc, Xuc, Xuc, Xuc, Xuc, Xuc, Xuc, Xuc, Xuc, Xuc, Xuc, Xuc, Xuc, Xuc, Xuc, Xuc, Xuc, Xuc, Xuc, Xuc, Xuc, Xuc, Xuc, Xuc, Xuc, Xuc^Efs, Ur, Ur, Ur, Ur, Ur, Xuc^Efs, Xuc, Xuc, Xuc, Xuc, Xuc, Xuc, Xuc, Xuc, Xuc, Xuc, Xuc
Xuc, Xuc, Xuc, Xuc, Xuc, Xuc, Xuc, Xuc, Xuc, Xuc, Xuc, Xuc, Xuc, Xuc, Xuc, Xuc, Xuc, Xuc, Xuc, Xuc, Xuc, Xuc, Xuc, Xuc, Xuc, Xuc, Xuc, Xuc, Xuc, Xuc, Xuc, Xuc, Xuc, Xuc, Xuc, Xuc, Xuc, Xuc, Xuc, Xuc, Xuc, Xuc^Efs, Ur, Ior, Ur, Ur, Ur, Xuc^Efs, Xuc^Efs, Xuc, Xuc, Xuc, Xuc, Xuc, Xuc, Xuc, Xuc, Xuc, Xuc
Xuc, Xuc, Xuc, Xuc, Xuc, Xuc, Xuc, Xuc, Xuc, Xuc, Xuc, Xuc, Xuc, Xuc, Xuc, Xuc, Xuc, Xuc, Xuc, Xuc, Xuc, Xuc, Xuc, Xuc, Xuc, Xuc, Xuc, Xuc, Xuc, Xuc, Xuc, Xuc, Xuc, Xuc, Xuc, Xuc, Xuc, Xuc, Xuc, Xuc, Xuc, Xuc^Efs, Xuc^Efs, Ur, Ur, Ur, Xuc^Efs, Ur, Ur, Xuc^Efs, Xu, Xuc, Xu, Xu, Xu, Xuc, Xu, Xuc, Xuc
Xuc, Xuc, Xuc, Xuc, Xuc, Xuc, Xuc, Xuc, Xuc, Xuc, Xuc, Xuc, Xuc, Xuc, Xuc, Xuc, Xuc, Xuc, Xuc, Xuc, Xuc, Xuc, Xuc, Xuc, Xuc, Xuc, Xuc, Xuc, Xuc, Xuc, Xuc, Xuc, Xuc, Xuc, Xuc, Xuc, Xuc, Xuc, Xuc, Xuc, Xuc, Xuc^Efs, Ur, Ur, Ur, Xuc^Efs, Xuc^Efs, Xuc^Efs, Ur, Xuc^Efs, Uu, Xu, Xu, Wwg, Uu, Xu, Uu, Xu, Xu
Xuc, Xuc, Xuc, Xuc, Xuc, Xuc, Xuc, Xuc, Xuc, Xuc, Xuc, Xuc, Xuc, Xuc, Xuc, Xuc, Xuc, Xuc, Xuc, Xuc, Xuc, Xuc, Xuc, Xuc, Xuc, Xuc, Xuc, Xuc, Xuc, Xuc, Xuc, Xuc, Xuc, Xuc, Xuc, Xuc, Xuc, Xuc, Xuc, Xuc, Xuc, Xuc^Efs, Ur, Ur, Ur, Xuc^Efs, Xuc^Efs, Ur, Ur, Xuc^Efs, Uu, Uu, Uu, Uu, Uu, Wwg, Uu, Uu, Xuc^Efs
Xuc, Xuc, Xuc, Xuc, Xuc, Xuc, Xuc, Xuc, Xuc, Xuc, Xuc, Xuc, Xuc, Xuc, Xuc, Xuc, Xuc, Xuc, Xuc, Xuc, Xuc, Xuc, Xuc, Xuc, Xuc, Xuc, Xuc, Xuc, Xuc, Xuc, Xuc, Xuc, Xuc, Xuc, Xuc, Xuc, Xuc, Xuc, Xuc, Xuc, Xuc, Xuc^Efs, Ur, Ior, Ur, Xuc^Efs, Xuc^Efs, Ur, Ur, Xuc^Efs, Uu, Uu, Uu, Uu, Xu, Uu, Uu, Xu, Xuc
Xuc, Xuc, Xuc, Xuc, Xuc, Xuc, Xuc, Xuc, Xuc, Xuc, Xuc, Xuc, Xuc, Xuc, Xuc, Xuc, Xuc, Xuc, Xuc, Xuc, Xuc, Xuc, Xuc, Xuc, Xuc, Xuc, Xuc, Xuc, Xuc, Xuc, Xuc, Xuc, Xuc, Xuc, Xuc, Xuc, Xuc, Xuc, Xuc, Xuc, Xuc, Xuc^Efs, Xuc^Efs, Ur, Xuc^Efs, Xuc^Efs, Ur, Ur, Xuc^Efs, Xuc^Efs, Xu, Xu, Xu, Xu, Xu, Uu, Xu, Xu, Xuc
Xuc, Xuc, Xuc, Xuc, Xuc, Xuc, Xuc, Xuc, Xuc, Xuc, Xuc, Xuc, Xuc, Xuc, Xuc, Xuc, Xuc, Xuc, Xuc, Xuc, Xuc, Xuc, Xuc, Xuc, Xuc, Xuc, Xuc, Xuc, Xuc, Xuc, Xuc, Xuc, Xuc, Xuc, Xuc, Xuc, Xuc, Xuc, Xuc, Xuc, Xuc, Xuc^Efs, Ur, Ur, Xuc^Efs, Xuc^Efs, Xuc^Efs, Ur, Ur, Xuc^Efs, Xuc, Xuc, Xuc, Xuc, Xuc, Xu, Xuc, Xuc, Xuc
Xuc, Xuc, Xuc, Xuc, Xuc, Xuc, Xuc, Xuc, Xuc, Xuc, Xuc, Xuc, Xuc, Xuc, Xuc, Xuc, Xuc, Xuc, Xuc, Xuc, Xuc, Xuc, Xuc, Xuc, Xuc, Xuc, Xuc, Xuc, Xuc, Xuc, Xuc, Xuc, Xuc, Xuc, Xuc, Xuc, Xuc, Xuc, Xuc, Xuc, Xuc, Xuc^Efs, Ur, Ur, Ur, Ur, Ur, Ur, Ur, Xuc^Efs, Xuc, Xuc, Xuc, Xuc, Xuc, Xuc, Xuc, Xuc, Xuc
Xuc, Xuc, Xuc, Xuc, Xuc, Xuc, Xuc, Xuc, Xuc, Xuc, Xuc, Xuc, Xuc, Xuc, Xuc, Xuc, Xuc, Xuc, Xuc, Xuc, Xuc, Xuc, Xuc, Xuc, Xuc, Xuc, Xuc, Xuc, Xuc, Xuc, Xuc, Xuc, Xuc, Xuc, Xuc, Xuc, Xuc, Xuc, Xuc, Xuc, Xuc, Xuc^Efs, Xuc^Efs, Ur, Ur, Ur, Ur, Ur, Xuc^Efs, Xuc^Efs, Xuc, Xuc, Xuc, Xuc, Xuc, Xuc, Xuc, Xuc, Xuc
Xuc, Xuc, Xuc, Xuc, Xuc, Xuc, Xuc, Xuc, Xuc, Xuc, Xuc, Xuc, Xuc, Xuc, Xuc, Xuc, Xuc, Xuc, Xuc, Xuc, Xuc, Xuc, Xuc, Xuc, Xuc, Xuc, Xuc, Xuc, Xuc, Xuc, Xuc, Xuc, Xuc, Xuc, Xuc, Xuc, Xuc, Xuc, Xuc, Xuc, Xuc, Xuc, Xuc, Xuc^Efs, Xuc^Efs, Xuc^Efs, Xuc^Efs, Xuc^Efs, Xuc, Xuc, Xuc, Xuc, Xuc, Xuc, Xuc, Xuc, Xuc, Xuc, Xuc
Xuc, Xuc, Xuc, Xuc, Xuc, Xuc, Xuc, Xuc, Xuc, Xuc, Xuc, Xuc, Xuc, Xuc, Xuc, Xuc, Xuc, Xuc, Xuc, Xuc, Xuc, Xuc, Xuc, Xuc, Xuc, Xuc, Xuc, Xuc, Xuc, Xuc, Xuc, Xuc, Xuc, Xuc, Xuc, Xuc, Xuc, Xuc, Xuc, Xuc, Xuc, Xuc, Xuc, Xuc, Xuc, Xuc, Xuc, Xuc, Xuc, Xuc, Xuc, Xuc, Xuc, Xuc, Xuc, Xuc, Xuc, Xuc, Xuc
