Xuc, Xuc, Xuc, Xuc, Xuc, Xuc, Xuc, Xuc, Xuc, Xuc, Xuc, Xuc, Xuc, Xuc, Xuc
Xuc, Xuc, Xuc, Xuc, Xuc, Xuc, Xuc, Xuc, Xuc, Xuc, Xuc, Xuc, Xuc, Xuc, Xuc
Xuc, Xuc, Xuc, Xuc, Xuc, Xuc, Xuc, Xuc, Xuc, Xuc, Xuc, Xuc, Xuc, Xuc, Xuc
Xuc, Xuc, Xuc, Xuc, Xuc, Xuc, Xuc, Ur, Ur, Xuc, Xuc, Xuc, Xuc, Xuc, Xuc
Xuc, Xuc, Xuc, Xuc, Xuc, Xuc, Xuc, Ur, Ur, Xuc, Ur, Ur, Ur, Xuc, Xuc
Xuc, Xuc, Xuc, Xuc, Xuc, Xuc, Ur, Ur, Ur, Xuc, Ur, Ur, Ur, Ur, Xuc
Xuc, Xuc, Xuc, Xuc, Ur, Ur, Ur, Ur, Ur, Xuc, Ur, Ur, Ur, Ur, Xuc
Xuc, Xuc, Xuc, Ur, Ior, Ur, Ur, Ur, Xuc, Xuc, Ur, Ur, Ur, Xuc, Xuc
Xuc, Xuc, Xuc, Ur, Ior, Ior^Br|, Ur, Ur, Xuc, Xuc, Ur, Ur, Ur, Xuc, Xuc
Xuc, Xuc, Xuc, Ur, Ur, Ur, Xuc, Xuc, Xuc, Xuc, Ur, Ur, Ur, Ur, Xuc
Xuc, Xuc, Xuc, Xuc, Xuc, Xuc, Xuc, Xuc, Ur, Ur, Ior, Ur, Ur, Ur, Xuc
Xuc, Xuc, Xuc, Xuc, Xuc, Xuc, Xuc, Xuc, Ur, Ior, Ior, Ur, Xuc, Xuc, Xuc
Xuc, Xuc, Xuc, Xuc, Xuc, Xuc, Xuc, Xuc, Xuc, Ur, Xuc, Ur, Xuc, Xuc, Xuc
Xuc, Xuc, Xuc, Xuc, Xuc, Xuc, Xuc, Xuc, Xuc, Xuc, Xuc, Xuc, Xuc, Xuc, Xuc
