Xuc, Xuc, Xuc, Xuc, Xuc, Xuc, Xuc, Xuc, Xuc, Xuc, Xuc, Xuc, Xuc, Xuc, Xuc, Xuc, Xuc, Xuc, Xuc, Xuc, Xuc, Xuc, Xuc, Xuc, Xuc, Xuc, Xuc
Xuc, Xuc, Xuc, Xuc, Xuc, Xuc, Xuc, Xuc, Xuc, Xuc, Xuc, Xuc, Xuc, Xuc, Xuc, Xuc, Xuc^Efs, Xuc, Xuc, Xuc, Xuc, Xuc, Xuc, Xuc, Xuc, Xuc, Xuc
Xuc, Xuc, Xuc, Xuc, Xuc, Xuc, Xuc, Xuc, Xuc, Xuc, Xuc, Xuc, Xuc, Xuc, Xuc, Xuc^Efs, Ior, Xuc^Efs, Xuc^Efs, Xuc, Xuc, Xuc, Xuc, Xuc, Xuc, Xuc, Xuc
Xuc, Xuc, Xuc, Xuc, Xuc, Xuc, Xuc, Xuc, Xuc, Xuc, Xuc, Xuc, Xuc, Xuc, Xuc, Xuc^Efs, Ior, Ior, Xuc^Efs, Xuc, Xuc, Xuc, Xuc, Xuc, Xuc, Xuc, Xuc
Xuc, Xuc, Xuc, Xuc, Xuc, Xuc, Xuc, Xuc, Xuc, Xuc, Xuc, Xuc, Xuc, Xuc, Xuc, Xuc^Efs, Xuc^Efs, Ur, Xuc^Efs, Xuc, Xuc, Xuc, Xuc, Xuc, Xuc, Xuc, Xuc
Xuc, Xuc, Xuc, Xuc, Xuc, Xuc, Xuc, Xuc, Xuc, Xuc, Xuc, Xuc, Xuc, Xuc, Xuc, Xuc, Xuc^Efs, Ur^Pr|, Xuc^Efs, Xuc, Xuc^Efs, Xuc^Efs, Xuc^Efs, Xuc, Xuc, Xuc, Xuc
Xuc, Xuc, Xuc, Xuc, Xuc, Xuc, Xuc, Xuc, Xuc, Xuc, Xuc, Xuc, Xuc, Xuc, Xuc^Efs, Xuc^Efs, Co^Br|, Ko, Co, Xuc^Efs, Ur, Ur, Ur, Xuc^Efs, Xuc^Efs, Xuc, Xuc
Xuc, Xuc, Xuc, Xuc, Xuc, Xuc, Xuc, Xuc, Xuc, Xuc, Xuc, Xuc, Xuc, Xuc^Efs, Ur, Ur, Ur^Br|, Ur, Ur, Xuc^Efs, Xuc^Efs, Ur, Qxu, Ur, Ur, Xuc^Efs, Xuc
Xuc, Xuc, Xuc, Xuc, Xuc, Xuc, Xuc, Xuc, Xuc, Xuc, Xuc, Xuc, Xu, Xuc^Efs, Xuc^Efs, Ur, Ur^Br|, Ur, Ior, Xuc^Efs, Xuc^Efs, Ur, Qxu, Qxu, Xuc^Efs, Xuc^Efs, Xuc
Xuc, Xuc, Xuc, Xuc, Xuc, Xuc, Xuc, Xuc, Xuc, Xuc, Xuc, Xu, Uu, Xu, Xuc^Efs, Ur, Ur^Br|, Ur, Ior, Ior, Xuc^Efs, Xuc^Efs, Xuc, Ur, Xuc^Efs, Xuc, Xuc
Xuc, Xuc, Xuc, Xuc, Xuc, Xuc, Xuc, Xuc, Xuc, Xuc, Xuc, Xu, Uu, Uu, Xuc^Efs, Ur, Ur^Br|, Ur^Br|, Ur, Ur, Xuc^Efs, Xu, Uu, Xuc, Xuc, Xuc, Xuc
Xuc, Xuc, Xuc, Xuc, Xuc, Xuc, Xuc, Xuc, Xuc, Xuc, Xuc^Efs, Xu, Xu, Uu, Xuc^Efs, Ur, Ur^Br|, Ur^Br|, Ur, Xuc^Efs, Xu, Uu, Uu, Xu, Xu, Xuc, Xuc
Xuc, Xuc, Xuc, Xuc, Xuc, Xuc, Xuc, Xuc, Xuc^Efs, Xuc^Efs, Ur, Xuc^Efs, Xuc, Xu, Xuc, Xuc^Efs, Ur^Br\, Ur^Br|, Ur, Xuc^Efs, Uu, Uu, Xu, Uu, Xu, Xuc, Xuc
Xuc, Xuc, Xuc, Xuc, Xuc, Xuc, Xuc^Efs, Xuc^Efs, Ur, Xuc^Efs, Ur, Xuc^Efs, Xuc, Xuc, Xuc^Efs, Xuc^Efs, Ur, Ur^Br|, Co, Xuc^Efs, Xu, Uu, Xu, Xu, Xuc, Xuc, Xuc
Xuc, Xuc, Xuc, Xuc, Xuc, Xuc^Efs, Ur, Ur, Ur, Ior, Ior^Br|, Xuc^Efs, Xuc, Xuc, Xuc^Efs, Ur, Qxu, Ur^Br|, Ko, Xuc^Efs, Xuc, Xu, Xuc, Xuc, Xuc, Xuc, Xuc
Xuc, Xuc, Xuc, Xuc, Xuc, Xuc^Efs, Xuc^Efs, Ur, Xuc^Efs, Ior, Xuc^Efs, Xuc^Efs, Xuc^Efs, Xuc^Efs, Ur, Ur, Qxu, Qxu, Co, Xuc^Efs, Xuc, Xuc, Xuc, Xuc, Xuc, Xuc, Xuc
Xuc, Xuc, Xuc^Efs, Xuc^Efs, Xuc^Efs, Xuc^Efs, Ur, Xuc^Efs, Xuc^Efs, Xuc^Efs, Xuc^Efs, Xuc^Efs, Ur, Ur, Ur^Br/, Ur^Br\, Ur^Br/, Ur^Br/, Ur^Br\, Xuc^Efs, Xuc, Xuc, Xuc, Xuc, Xuc, Xuc, Xuc
Xuc, Xuc, Xuc^Efs, Ur, Qxu, Co, Ko, Ur, Xuc^Efs, Xuc^Efs, Xuc^Efs, Ur^Br|, Co^Br|, Ur^Br/, Ur, Ur, Ur, Ur, Xuc^Efs, Xuc^Efs, Xuc, Xuc, Xuc, Xuc, Xuc, Xuc, Xuc
Xuc, Xuc, Xuc^Efs, Ur, Qxu, Qxu, Ur, Co, Xuc^Efs, Ur, Ior, Ko^Br|, Co^Br|, Ur, Xuc^Efs, Xuc, Xuc, Xuc, Xu, Xuc, Xuc, Xuc, Xuc, Xuc, Xuc, Xuc, Xuc
Xuc, Xuc, Xuc^Efs, Ur, Ur, Ur, Xuc^Efs, Xuc^Efs, Xuc, Ur, Ior, Ior^Br|, Ur^Br|, Ur, Xuc^Efs, Uu, Xu, Uu, Uu, Xu, Xuc, Xuc, Xuc, Xuc, Xuc, Xuc, Xuc
Xuc, Xuc, Xuc, Xuc^Efs, Xuc^Efs, Xuc^Efs, Xu, Xu, Uu, Xuc, Xuc^Efs, Ur^Br|, Ur^Br|, Ur, Ur, Xuc^Efs, Xuc^Efs, Uu, Xu, Xu, Xuc, Xuc, Xuc, Xuc, Xuc, Xuc, Xuc
Xuc, Xuc, Xuc, Xuc, Xuc, Xuc, Xu, Uu, Uu, Uu, Xuc^Efs, Ur^Br|, Ur^Br|, Ur, Ur, Ur, Ur, Xuc^Efs, Xuc, Xuc, Xuc, Xuc, Xuc, Xuc, Xuc, Xuc, Xuc
Xuc^Efs, Xuc, Xuc, Xuc, Xuc, Xuc, Xu, Uu, Uu, Uu, Xuc^Efs, Ur^Br|, Ur^Br|, Ur, Ur, Ur, Xuc^Efs, Xuc^Efs, Xuc, Xuc, Xuc, Xuc, Xuc, Xuc, Xuc, Xuc, Xuc
Ur, Xuc^Efs, Xuc^Efs, Xuc, Xuc^Efs, Xuc, Xu, Uu, Xuc^Efs, Xuc^Efs, Xuc^Efs, Ce^Br|, Ke^Br|, Ce, Xuc^Efs, Xuc^Efs, Xuc, Xuc, Xuc, Xuc, Xuc, Xuc, Xuc, Xuc, Xuc, Xuc, Xuc
Ur, Ur^Br|, Xuc^Efs, Xuc^Efs, Ur, Xuc^Efs, Xuc^Efs, Xu, Xuc^Efs, Ur, Ior, Ce^Br|, Ur^Br|, Ce, Xuc^Efs, Xuc, Xuc, Xuc, Xuc, Xuc, Xuc, Xuc, Xuc, Xuc, Xuc, Xuc, Xuc
Ur, Ur^Br|, Xuc^Efs, Xuc^Efs, Ur, Ur, Xuc^Efs, Xuc, Xuc, Xuc^Efs, Ior, Ior^Br|, Ur^Br/, Ur, Xuc^Efs, Xuc, Xuc, Xuc, Xuc, Xuc, Xuc, Xuc, Xuc, Xuc, Xuc, Xuc, Xuc
Ur, Ur^Br|, Xuc^Efs, Xuc^Efs, Ur, Ur, Xuc^Efs, Xuc^Efs, Xuc^Efs, Xuc^Efs, Xuc^Efs, Ur^Br|, Ur, Ur, Qxu, Xuc^Efs, Xuc, Xuc, Xuc, Xuc, Xuc, Xuc, Xuc, Xuc, Xuc, Xuc, Xuc
Ur, Ur^Br|, Ur, Ur, Ur, Ur, Ur, Ur, Ur, Ur, Ur, Ur^Br|, Ur, Qxu, Qxu, Xuc^Efs, Xuc, Xuc, Xuc, Xuc, Xuc, Xuc, Xuc, Xuc, Xuc, Xuc, Xuc
