Qxu, Qxu, Ms^Xm, Ms^Xm, Xu, Xu, Xu, Wog, Wog, Wog, Xu, Xu, Ms^Xm, Ms^Xm, Ms^Xm, Ms^Xm, Ms^Xm, Rb, Aa, Aa, Ms^Xm, Ms^Xm, Ms^Xm
Qxu, Qxu, Qxu, Ms^Xm, Xu, Xu, Xu, Wog, Wog, Wog, Xu, Xu, Ms^Xm, Ms^Xm, Ms^Xm, Ms^Xm, Ms^Xm, Rb, Aa, Aa, Ms^Xm, Ms^Xm, Ms^Xm
Qxu, Qxu, Aa, Ms^Xm, Xu, Xu, Ur, Wog, Wog, Wog, Xu, Xu, Xu, Ms^Xm, Ms^Xm, Ms^Xm, Ms^Xm, Rb, Aa, Aa, Ms^Xm, Ms^Xm, Ms^Xm
Qxu, Qxu, Aa, Aa, Ur, Xu, Ur, Ur, Wog^Bs\, Xu, Ur, Xu, Xos, Xu, Xu, Ms^Xm, Ms^Xm, Rb, Aa, Aa, Ms^Xm, Ms^Xm, Ms^Xm
Qxu, Qxu, Aa, Aa, Xu, Ur, Xu, Ur, Wog, Ur, Ur, Ur, Irs, Xoc, Xoc, Xoc, Ms^Xm, Rb, Aa, Aa, Ms^Xm, Ms^Xm, Ms^Xm
Qxu, Qxu, Qxu, Ms^Xm, Xu, Xu, Xu, Wog, Wog, Xu, Xu, Xu, Xoc, Xom, Irs, Xoc, Ms^Xm, Rb, Aa, Aa, Ms^Xm, Ms^Xm, Ms^Xm
Qxu, Qxu, Ms^Xm, Ms^Xm, Ms^Xm, Xu, Ms^Xm, Wog, Wog, Wog, Xu, Xu, Xoc, Irs, Irs, Xoc, Ms^Xm, Rb, Aa, Aa, Ms^Xm, Ms^Xm, Ms^Xm
Ms^Xm, Ms^Xm, Ms^Xm, Ms^Xm, Ms^Xm, Ms^Xm, Ms^Xm, Ms^Xm, Ms^Xm, Wog, Ms^Xm, Xu, Xoc, Irs, Irs, Xoc, Ms^Xm, Rb, Aa, Aa, Ms^Xm, Ms^Xm, Ms^Xm
Ms^Xm, Ms^Xm, Ms^Xm, Ms^Xm, Ms^Xm, Ms^Xm, Ms^Xm, Ms^Xm, Ms^Xm, Ms^Xm, Ms^Xm, Xu, Xu, Xoc, Irs, Xoc, Ms^Xm, Rb, Aa, Aa, Ms^Xm, Ms^Xm, Ms^Xm
Ms^Xm, Ms^Xm, Ms^Xm, Ms^Xm, Ms^Xm, Ms^Xm, Ms^Xm, Ms^Xm, Ms^Xm, Ms^Xm, Ms^Xm, Xoc, Xoc, Xoc, Irs, Xoc, Ms^Xm, Rb, Aa, Aa, Ms^Xm, Ms^Xm, Ms^Xm
Ms^Xm, Ms^Xm, Ms^Xm, Ms^Xm, Ms^Xm, Ms^Xm, Ms^Xm, Ms^Xm, Ms^Xm, Ms^Xm, Aa, Irs, Irs, Irs, Xoc, Xoc, Ms^Xm, Rb, Ms^Xm, Aa, Ms^Xm, Ms^Xm, Ms^Xm
Ms^Xm, Ms^Xm, Ms^Xm, Ms^Xm, Ms^Xm, Ms^Xm, Ha, Aa, Aa, Aa, Aa, Ms^Xm, Ms^Xm, Xoc, Ms^Xm, Ms^Xm, Ms^Xm, Rr^Pw|, Ms^Xm, Ms^Xm, Ms^Xm, Ms^Xm, Ms^Xm
Ms^Xm, Ms^Xm, Ms^Xm, Ms^Xm, Ms^Xm, Aa, Ha, Aa, Cha, Rrc^Vhca, Cha, Ha, Ms^Xm, Ms^Xm, Ms^Xm, Ms^Xm, Aa, Rb, Aa, Aa^Vca, Aa, Ms^Xm, Ms^Xm
Ms^Xm, Ms^Xm, Ms^Xm, Ms^Xm, Ms^Xm, Ms^Xm, Ms^Xm, Aa, Aa, Rrc, Rrc, Rrc, Ms^Xm, Ms^Xm, Ms^Xm, Aa, Rb, Rb, Aa, Aa, Ms^Xm, Ms^Xm, Ms^Xm
Ms^Xm, Ms^Xm, Ms^Xm, Ms^Xm, Ms^Xm, Ms^Xm, Ms^Xm, Ms^Xm, Ms^Xm, Aa, Ms^Xm, Rrc, Aa, Ms^Xm, Aa, Aa, Rb, Aa, Aa, Ms^Xm, Ms^Xm, Ms^Xm, Qxu
Ms^Xm, Ms^Xm, Ms^Xm, Ms^Xm, Ms^Xm, Ms^Xm, Ha, Aa, Aa, Ms^Xm, Rrc, Rrc, Rrc, Rb, Rb, Rb, Rb, Cea, Aa, Aa, Qxu, Qxu, Qxu
Ms^Xm, Ms^Xm, Ms^Xm, Ms^Xm, Ms^Xm, Aa, Aa, Aa, Cha, Aa, Aa, Rrc, Rrc, Ha, Aa, Aa, Aa, Aa^Vha, Aa, Qxu, Qxu, Qxu, Qxu
Ms^Xm, Ms^Xm, Ms^Xm, Ms^Xm, Ha, Aa, Aa, Cha, Cha, Cha, Rrc^Vhca, Aa, Rrc, Aa, Rrc^Vhca, Aa, Aa, Aa, Qxu, Qxu, Qxu, Qxu, Qxu
Ms^Xm, Ms^Xm, Ms^Xm, Ms^Xm, Ha, Ha, Aa, Aa, Aa, Aa, Rrc, Rrc, Rrc, Rrc, Aa, Cha, Aa, Aa, Qxu, Qxu, Qxu, Qxu, Qxu
Ms^Xm, Ms^Xm, Ms^Xm, Ms^Xm, Aa, Aa, Aa, Aa, Rrc, Rrc, Aa, Rrc, Aa, Rrc, Rrc, Rrc, Aa, Qxu, Qxu, Qxu, Qxu, Qxu, Qxu
Ms^Xm, Ms^Xm, Ms^Xm, Ms^Xm, Aa, Cha, Cha, Cha, Rrc, Aa, Cha, Cha, Cha, Aa, Aa, Rrc, Aa, Qxu, Qxu, Qxu, Qxu, Qxu, Qxu
Ms^Xm, Ms^Xm, Ms^Xm, Aa, Aa, Cha, Cha, Rrc^Vhca, Rrc, Aa, Aa, Cha, Cha, Cha, Aa, Rrc, Aa, Qxu, Qxu, Qxu, Qxu, Qxu, Qxu
Ms^Xm, Ms^Xm, Ms^Xm, Ms^Xm, Aa, Cha, Cha, Aa, Rrc, Rrc, Aa, Aa^Vea, Cha, Aa, Rrc, Rrc, Aa, Qxu, Qxu, Qxu, Qxu, Qxu, Qxu
Ms^Xm, Ms^Xm, Ms^Xm, Ms^Xm, Aa, Cha, Cha, Aa, Aa, Rrc, Rrc, Rrc, Rrc, Rrc, Aa, Rrc, Rrc, Qxu, Qxu, Qxu, Qxu, Qxu, Qxu
Ms^Xm, Ms^Xm, Ms^Xm, Aa, Aa, Cha, Aa, Aa, Aa, Aa, Rrc, Rrc, Rrc, Aa, Cha, Aa, Rrc, Qxu, Qxu, Qxu, Qxu, Qxu, Qxu
Ms^Xm, Ms^Xm, Ms^Xm, Ms^Xm, Ms^Xm, Ms^Xm, Ms^Xm, Aa, Aa, Aa, Rrc, Rrc, Rrc, Aa, Rrc^Vhca, Aa, Rrc, Aa, Qxu, Qxu, Qxu, Qxu, Qxu
Ms^Xm, Ms^Xm, Ms^Xm, Ms^Xm, Ms^Xm, Ms^Xm, Ms^Xm, Aa, Aa, Aa^Vca, Aa, Rrc, Aa, Rrc, Rrc, Rrc, Aa, Aa, Qxu, Qxu, Qxu, Qxu, Qxu
Qxu, Qxu, Qxu, Qxu, Qxu, Qxu, Qxu, Qxu, Qxu, Qxu, Qxu, Qxu^Bs|, Qxu, Qxu, Qxu, Qxu, Qxu, Qxu, Qxu, Qxu, Qxu, Qxu, Qxu
Qxu, Qxu, Qxu, Qxu, Qxu, Qxu, Qxu, Qxu, Qxu, Qxu, Qxu, Qxu^Bs|, Qxu, Qxu, Qxu, Qxu, Qxu, Qxu, Qxu, Qxu, Qxu, Qxu, Qxu
Qxu, Qxu, Qxu, Qxu, Qxu, Qxu, Qxu, Qxu, Qxu, Qxu, Qxu, Qxu^Bs|, Qxu, Qxu, Qxu, Qxu, Qxu, Qxu, Qxu, Qxu, Qxu, Qxu, Qxu
Ms^Xm, Ms^Xm, Ms^Xm, Ms^Xm, Ms^Xm, Ms^Xm, Ms^Xm, Ms^Xm, Ms^Xm, Ms^Xm, Ms^Xm, Qxu^Bs|, Ms^Xm, Ms^Xm, Ms^Xm, Ms^Xm, Ms^Xm, Ms^Xm, Ms^Xm, Ms^Xm, Ms^Xm, Ms^Xm, Ms^Xm
Ms^Xm, Ms^Xm, Ms^Xm, Ms^Xm, Ms^Xm, Ms^Xm, Ms^Xm, Ms^Xm, Ms^Xm, Ms^Xm, Ms^Xm, Rr^Pw|, Ms^Xm, Ms^Xm, Ms^Xm, Ms^Xm, Ms^Xm, Ms^Xm, Ms^Xm, Ms^Xm, Ms^Xm, Ms^Xm, Ms^Xm
