Xoc, Xoc, Xoc, Xoc, Xoc, Xoc, Xoc, Xoc, Xoc, Xoc, Xoc, Xoc, Xoc, Xoc, Xoc, Xoc, Xoc, Xoc, Xoc, Xoc, Xoc, Xoc
Xoc, Xoc, Xoc, Xoc, Xoc, Xoc, Xoc, Xoc, Xoc, Xoc, Xoc, Xoc, Xoc, Xoc, Xoc, Xoc, Xoc, Xoc, Xoc, Xoc, Xoc, Xoc
Xoc, Xoc, Xoc, Xoc, Xoc, Xoc, Xoc, Irs, Irs, Irs, Irs, Irs, Xoc, Xoc, Xoc, Xoc, Xoc, Xoc, Xoc, Xoc, Xoc, Xoc
Xoc, Xoc, Xoc, Xoc, Xoc, Xoc, Xoc, Irs, Irs, Irs, Irs, Irs, Xoc, Xoc, Xoc, Xoc, Xoc, Xoc, Xoc, Xoc, Xoc, Xoc
Xoc, Xoc, Xoc, Xoc, Xoc, Xoc, Xoc, Irs, Irs, Irs, Irs, Irs, Xoc, Xoc, Xoc, Xoc, Xoc, Xoc, Xoc, Xoc, Xoc, Xoc
Xoc, Xoc, Xoc, Xoc, Xoc, Xoc, Xoc, Irs, Irs, Irs, Irs, Irs, Xoc, Xoc, Xoc, Xoc, Xoc, Xoc, Xoc, Xoc, Xoc, Xoc
Xoc, Xoc, Xoc, Xoc, Xoc, Xoc, Xoc, Irs, Irs, Irs, Irs, Irs, Xoc, Xoc, Xoc, Xoc, Xoc, Xoc, Xoc, Xoc, Xoc, Xoc
Xoc, Xoc, Xoc, Irs, Xoc, Xoc, Xoc, Xoc, Irs, Irs, Irs, Xoc, Xoc, Xoc, Irs, Irs, Irs, Xoc, Xoc, Xoc, Xoc, Xoc
Xoc, Xoc, Irs, Irs, Irs, Irs, Irs, Irs, Irs, Irs, Irs, Irs, Irs, Irs, Irs, Irs, Irs, Xoc, Xoc, Xoc, Xoc, Xoc
Xoc, Xoc, Xoc, Irs, Xoc, Irs, Xoc, Irs, Irs, Irs, Irs, Irs, Xoc, Irs, Irs, Irs, Irs, Xoc, Irs, Xoc, Xoc, Xoc
Xoc, Xoc, Xoc, Irs, Xoc, Xoc, Xoc, Xoc, Irs, Irs, Irs, Xoc, Xoc, Xoc, Irs, Irs, Irs, Irs, Irs, Irs, Xoc, Xoc
Aa, Xoc, Aa, Xoc, Aa, Xoc, Aa, Xoc, Irs, Irs, Irs, Xoc, Ms^Xm, Xoc, Xoc, Irs, Xoc, Irs, Xoc, Irs, Xoc, Xoc
Aa, Aa, Aa, Aa, Aa, Ms^Xm, Aa, Xoc, Xoc, Irs, Xoc, Xoc, Ms^Xm, Ms^Xm, Ms^Xm, Xos, Ms^Xm, Xoc, Ms^Xm, Xos, Ms^Xm, Xoc
Aa, Aa, Aa, Aa, Aa, Ms^Xm, Aa, Aa, Xoc, Irs, Xoc, Ms^Xm, Ms^Xm, Aa^Fpa, Aa^Fpa, Ms^Xm, Aa^Fpa, Ms^Xm, Aa^Fpa, Ms^Xm, Aa^Fpa, Ms^Xm
Aa, Aa, Aa, Aa, Aa, Ms^Xm, Ms^Xm, Ms^Xm, Ms^Xm, Aa, Aa, Aa^Fpa, Aa^Fpa, Aa^Fpa, Aa, Aa^Fpa, Aa, Aa^Fpa, Aa, Aa^Fpa, Aa, Aa^Fpa
Aa, Aa, Aa, Aa, Aa, Ms^Xm, Ms^Xm, Ms^Xm, Ms^Xm, Aa, Aa, Aa, Aa, Aa, Aa, Aa, Aa, Aa, Aa, Aa, Aa, Aa
Aa, Aa, Aa, Aa, Aa, Ms^Xm, Ms^Xm, Ms^Xm, Ms^Xm, Aa^Fpa, Aa, Aa, Aa, Aa, Aa, Aa, Aa, Aa, Aa, Aa, Aa, Aa
Aa, Aa, Aa, Aa, Aa, Aa, Aa, Ms^Xm, Ms^Xm, Aa^Fpa, Aa, Aa, Aa^Vha, Aa, Aa, Aa, Aa, Aa, Aa, Aa, Aa, Aa
Aa, Aa, Aa, Aa, Aa, Aa, Aa, Ms^Xm, Ms^Xm, Aa^Fpa, Aa, Aa, Aa, Aa, Aa, Aa, Aa, Aa, Aa, Aa, Aa, Aa
Aa, Aa, Aa, Aa, Aa, Aa, Aa, Ms^Xm, Ms^Xm, Aa^Fpa, Aa, Aa, Aa, Aa, Aa, Aa, Aa, Aa, Aa, Aa, Aa, Aa
Aa, Aa, Aa, Aa, Aa, Aa, Aa, Ms^Xm, Ms^Xm, Aa^Fpa, Aa, Aa, Aa, Aa, Aa, Aa, Aa, Aa, Aa, Aa, Aa, Aa
Aa, Aa, Aa, Aa, Aa, Aa, Ms^Xm, Ms^Xm, Aa^Fpa, Aa^Fpa, Aa^Fpa, Aa^Fpa, Aa, Aa^Fpa, Aa^Fpa, Aa^Fpa, Aa^Fpa, Aa^Fpa, Aa^Fpa, Aa, Rb, Rb
Aa, Aa, Aa, Aa, Aa, Ms^Xm, Ms^Xm, Aa^Fpa, Aa^Fpa, Aa^Fpa, Ms^Xm, Ms^Xm, Ms^Xm, Ms^Xm, Ms^Xm, Ms^Xm, Ms^Xm, Ms^Xm, Ms^Xm, Rb, Rb, Rb
Aa, Aa, Aa, Aa, Aa, Ms^Xm, Ms^Xm, Aa^Fpa, Aa^Fpa, Aa^Fpa, Ms^Xm, Ms^Xm, Ms^Xm, Aa, Aa, Ms^Xm, Aa, Aa, Ms^Xm, Rb, Rb, Aa
Aa, Aa, Aa, Aa, Aa, Ms^Xm, Ms^Xm, Aa, Ms^Xm, Ms^Xm, Ms^Xm, Ms^Xm, Ms^Xm, Aa, Ms^Xm, Ms^Xm, Ms^Xm, Aa, Ms^Xm, Rb, Rb, Rb
Ms^Xm, Aa, Aa, Aa, Aa, Aa, Ms^Xm, Aa, Ms^Xm, Ms^Xm, Ms^Xm, Ms^Xm, Aa, Aa, Ms^Xm, Ms^Xm, Ms^Xm, Ms^Xm, Aa^Fpa, Rb, Aa, Rb
Aa, Ms^Xm, Ms^Xm, Aa, Aa, Aa, Ms^Xm, Aa, Ms^Xm, Ms^Xm, Ms^Xm, Ms^Xm, Ms^Xm, Ms^Xm, Aa, Ms^Xm, Ms^Xm, Ms^Xm, Ms^Xm, Aa^Fpa, Aa^Fpa, Aa
Aa, Aa, Aa, Ms^Xm, Ms^Xm, Ms^Xm, Ms^Xm, Aa, Ms^Xm, Ms^Xm, Ms^Xm, Aa, Aa, Aa, Aa, Ms^Xm, Aa, Ms^Xm, Ms^Xm, Ms^Xm, Ms^Xm, Aa^Fpa
Aa, Aa, Aa, Aa, Aa, Ms^Xm, Ms^Xm, Aa, Ms^Xm, Ms^Xm, Aa, Aa, Aa, Aa, Aa, Aa, Aa, Aa, Ms^Xm, Ms^Xm, Ms^Xm, Aa^Fpa
Aa, Aa, Aa, Aa, Ms^Xm, Ms^Xm, Aa^Fpa, Aa, Ms^Xm, Ms^Xm, Aa, Aa, Aa, Aa, Aa, Aa, Aa, Aa, Ms^Xm, Ms^Xm, Ms^Xm, Aa^Fpa
Aa, Aa, Ms^Xm, Ms^Xm, Aa^Fpa, Aa^Fpa, Aa, Aa, Ms^Xm, Ms^Xm, Aa, Aa, Aa, Aa, Aa, Aa, Ms^Xm, Ms^Xm, Ms^Xm, Ms^Xm, Aa^Fpa, Aa^Fpa
Aa, Aa, Ms^Xm, Aa^Fpa, Aa, Aa, Aa, Aa^Fpa, Ms^Xm, Ms^Xm, Aa, Aa, Aa, Aa, Aa, Aa, Ms^Xm, Ms^Xm, Ms^Xm, Ms^Xm, Aa^Fpa, Aa
Aa, Aa, Ms^Xm, Aa^Fpa, Aa, Aa, Aa^Fpa, Aa^Fpa, Ms^Xm, Ms^Xm, Ms^Xm, Aa, Aa, Aa, Aa, Ms^Xm, Ms^Xm, Ms^Xm, Aa^Fpa, Aa^Fpa, Rb, Rb
Aa, Aa, Ms^Xm, Aa^Fpa, Aa, Aa, Aa^Fpa, Ms^Xm, Ms^Xm, Ms^Xm, Ms^Xm, Ms^Xm, Aa, Aa, Aa, Ms^Xm, Ms^Xm, Ms^Xm, Aa^Fpa, Aa, Rb, Rb
Ms^Xm, Ms^Xm, Ms^Xm, Aa^Fpa, Aa^Fpa, Aa, Aa, Aa^Fpa, Aa^Fpa, Ms^Xm, Ms^Xm, Aa, Aa, Aa, Aa, Ms^Xm, Ms^Xm, Ms^Xm, Aa^Fpa, Rb, Rb, Rb
Aa, Ms^Xm, Aa, Ms^Xm, Ms^Xm, Aa^Fpa, Aa, Aa, Aa, Aa^Fpa, Ms^Xm, Ms^Xm, Ms^Xm, Ms^Xm, Ms^Xm, Ms^Xm, Aa^Fpa, Aa^Fpa, Rb, Rb, Rb, Rb
Aa, Aa, Aa, Aa, Ms^Xm, Aa^Fpa, Aa, Aa, Aa, Aa^Fpa, Aa^Fpa, Ms^Xm, Aa^Fpa, Ms^Xm, Aa^Fpa, Aa^Fpa, Aa, Aa, Rb, Rb, Rb, Rb
Aa, Aa, Aa, Aa, Ms^Xm, Aa^Fpa, Aa, Aa, Aa, Aa, Aa, Aa^Fpa, Cea, Aa^Fpa, Aa, Aa, Aa, Aa, Rb, Rb, Rb, Rb
Aa, Aa, Aa, Aa, Ms^Xm, Aa^Fpa, Aa^Fpa, Aa, Aa, Aa, Aa, Cea, Kea, Cea, Aa, Aa, Rb, Rb, Rb, Rb, Rb, Rb
Aa, Aa, Aa, Aa, Aa, Ms^Xm, Ms^Xm, Aa^Fpa, Aa^Fpa, Aa, Aa^Fpa, Cea, Cea, Cea, Aa^Fpa, Aa, Rb, Rb, Rb, Rb, Rb, Rb
Aa, Aa, Aa, Aa, Aa, Aa, Ms^Xm, Ms^Xm, Aa^Fpa, Aa^Fpa, Aa^Fpa, Aa^Fpa, Aa^Fpa, Aa^Fpa, Qxu, Aa^Fpa, Aa^Fpa, Rb, Rb, Rb, Rb, Rb
Aa, Aa, Aa, Aa, Aa, Ms^Xm, Ms^Xm, Ms^Xm, Aa^Fpa, Aa^Fpa, Aa^Fpa, Aa^Fpa, Qxu, Qxu, Qxu, Qxu, Qxu, Rb, Qxu, Aa, Qxu, Rb
Aa, Aa, Aa, Aa, Aa, Ms^Xm, Ms^Xm, Ms^Xm, Ms^Xm, Aa^Fpa, Aa^Fpa, Aa^Fpa, Qxu, Qxu, Qxu, Qxu, Qxu, Qxu, Qxu, Qxu, Qxu, Qxu
Aa, Aa, Aa, Aa, Aa, Ms^Xm, Ms^Xm, Ms^Xm, Ms^Xm, Aa^Fpa, Aa^Fpa, Aa^Fpa, Qxu, Qxu, Qxu, Qxu, Qxu, Qxu, Qxu, Qxu, Qxu, Qxu
Aa, Aa, Aa, Aa, Aa, Ms^Xm, Ms^Xm, Ms^Xm, Ms^Xm, Aa^Fpa, Qxu, Qxu, Qxu, Qxu, Qxu, Qxu, Qxu, Qxu, Qxu, Qxu, Qxu, Qxu
Aa, Aa, Aa, Aa, Aa, Ms^Xm, Ms^Xm, Ms^Xm, Ms^Xm, Aa^Fpa, Qxu, Qxu, Qxu, Qxu, Qxu, Qxu, Qxu, Qxu, Qxu, Qxu, Rb, Qxu
Aa, Aa, Aa, Aa, Aa, Ms^Xm, Ms^Xm, Ms^Xm, Aa, Ms^Xm, Qxu, Qxu, Qxu, Qxu, Qxu, Qxu, Qxu, Qxu, Qxu, Aa, Rb, Rb
