Ms^Xm, Ms^Xm, Aa, Aa, Qxu, Qxu, Qxu, Qxu, Qxu, Qxu, Qxu, Qxu, Qxu, Qxu, Qxu, Qxu, Qxu, Qxu, Qxu, Qxu, Qxu, Qxu, Aa, Rb, Rb, Ms^Xm, Ms^Xm, Ms^Xm, Aa, Aa, Aa, Aa, Aa, Aa, Aa, Aa, Aa, Aa
Ms^Xm, Ms^Xm, Aa, Aa, Aa, Qxu, Qxu, Qxu, Qxu, Qxu, Qxu, Qxu, Qxu, Qxu, Qxu, Qxu, Qxu, Qxu, Qxu, Qxu, Qxu, Qxu, Aa, Rb, Rb, Ms^Xm, Ms^Xm, Ms^Xm, Aa, Aa, Aa, Aa, Aa, Aa, Aa, Aa, Aa, Aa
Ms^Xm, Ms^Xm, Aa, Aa, Aa, Aa, Aa, Qxu, Qxu, Qxu, Qxu, Qxu, Qxu, Qxu, Qxu, Qxu, Qxu, Qxu, Qxu, Qxu, Qxu, Qxu, Aa, Rb, Rb, Ms^Xm, Ms^Xm, Ms^Xm, Aa, Aa, Aa, Aa, Aa, Aa, Aa, Aa, Aa, Aa
Ms^Xm, Ms^Xm, Aa, Aa, Aa, Aa, Aa, Aa, Aa, Qxu, Qxu, Qxu, Qxu, Qxu, Qxu, Qxu, Qxu, Qxu, Qxu, Qxu, Qxu, Qxu, Aa, Rb, Aa, Aa, Ms^Xm, Ms^Xm, Aa, Aa, Aa, Aa, Aa, Aa, Aa, Aa, Aa, Aa
Ms^Xm, Ms^Xm, Aa, Aa, Aa, Aa, Aa, Aa, Aa, Aa, Aa, Qxu, Qxu, Qxu, Qxu, Qxu, Qxu, Qxu, Qxu, Qxu, Aa, Aa, Aa, Rb, Rb, Aa, Aa, Ms^Xm, Ms^Xm, Aa, Aa, Aa, Aa, Aa, Aa, Aa, Aa, Aa
Ms^Xm, Ms^Xm, Aa, Aa, Aa, Aa, Aa, Aa, Aa, Aa, Aa, Aa, Aa, Qxu, Qxu, Qxu, Qxu, Qxu, Qxu, Qxu, Rb, Aa, Aa, Aa, Aa, Aa, Aa, Aa, Aa, Ms^Xm, Ms^Xm, Aa, Aa, Aa, Aa, Aa, Aa, Aa
Ms^Xm, Ms^Xm, Aa, Aa, Aa, Aa, Aa, Aa, Aa, Aa, Aa, Aa, Aa, Aa, Ms^Xm, Qxu, Qxu, Qxu, Rb, Rb, Ms^Xm, Ms^Xm, Aa, Aa, Aa, Aa, Ms^Xm, Aa, Aa, Aa, Aa, Ms^Xm, Aa, Aa, Aa, Aa, Aa, Aa
Ms^Xm, Ms^Xm, Aa, Aa, Aa, Aa, Aa, Aa, Aa, Aa, Aa, Aa, Aa, Aa, Ms^Xm, Qxu, Aa^Fpa, Rb, Ms^Xm, Ms^Xm, Aa, Ms^Xm, Ms^Xm, Ms^Xm, Ms^Xm, Ms^Xm, Aa, Ms^Xm, Ms^Xm, Aa, Aa, Aa, Aa, Aa, Aa, Aa, Aa, Aa
Ms^Xm, Ms^Xm, Aa, Aa, Aa, Aa, Aa, Aa, Aa, Aa, Aa, Aa, Aa, Aa, Ms^Xm, Ms^Xm, Ms^Xm, Rb, Ms^Xm, Ms^Xm, Aa, Ms^Xm, Aa, Ms^Xm, Aa, Aa, Aa, Aa, Ms^Xm, Aa, Aa, Aa, Aa, Aa, Aa, Aa, Aa, Aa
Ms^Xm, Ms^Xm, Aa, Aa, Aa, Aa, Aa, Aa, Aa, Aa, Aa, Aa, Aa, Aa, Ms^Xm, Ms^Xm, Ms^Xm, Rb, Ms^Xm, Aa, Aa, Aa, Aa, Aa, Aa, Aa, Aa, Aa, Ms^Xm, Aa, Aa, Aa, Aa, Aa, Aa, Aa, Aa, Aa
Ms^Xm, Ms^Xm, Aa, Aa, Aa, Aa, Aa, Aa, Aa, Aa, Aa, Aa, Aa, Aa, Aa, Aa, Ms^Xm, Aa, Aa, Ms^Xm, Aa, Aa, Aa, Aa, Aa, Aa, Aa, Aa, Ms^Xm, Aa, Aa, Aa, Aa, Aa, Aa, Aa, Aa, Aa
Ms^Xm, Ms^Xm, Aa, Aa, Aa, Aa, Aa, Ms^Xm, Ms^Xm, Ms^Xm, Ms^Xm, Ms^Xm, Ms^Xm, Aa, Aa, Aa, Ms^Xm, Aa, Aa, Ms^Xm, Ms^Xm, Aa, Aa, Aa, Aa, Aa, Aa, Aa, Aa, Aa, Aa, Aa, Aa, Aa, Aa, Aa, Aa, Aa
Ms^Xm, Ms^Xm, Aa, Aa, Aa, Aa, Ms^Xm, Ms^Xm, Ms^Xm, Aa^Fpa, Aa^Fpa, Ms^Xm, Ms^Xm, Ms^Xm, Ms^Xm, Ms^Xm, Aa^Fpa, Aa, Aa, Aa^Fpa, Ms^Xm, Ms^Xm, Ms^Xm, Aa, Aa, Aa, Aa, Aa, Aa, Aa, Aa, Aa, Aa, Aa, Aa, Aa, Aa, Aa
Ms^Xm, Ms^Xm, Aa, Aa, Aa, Ms^Xm, Ms^Xm, Ms^Xm, Aa^Fpa, Aa^Fpa, Aa^Fpa, Aa^Fpa, Aa^Fpa, Ms^Xm, Ms^Xm, Aa^Fpa, Rb, Rb, Aa^Fpa, Aa^Fpa, Aa^Fpa, Ms^Xm, Aa, Aa, Aa, Aa, Aa, Aa, Aa, Aa, Aa, Aa, Aa, Aa, Aa, Aa, Aa, Aa
Ms^Xm, Ms^Xm, Aa, Aa, Ms^Xm, Ms^Xm, Ms^Xm, Aa^Fpa, Aa^Fpa, Rb, Rb, Aa^Fpa, Aa^Fpa, Aa^Fpa, Aa^Fpa, Rb, Rb, Aa^Fpa, Aa^Fpa, Aa^Fpa, Aa^Fpa, Ms^Xm, Aa, Aa, Aa, Aa, Aa, Aa, Aa, Aa, Aa, Aa, Aa, Aa, Aa, Aa, Aa, Aa
Ms^Xm, Ms^Xm, Aa, Aa, Ms^Xm, Ms^Xm, Aa^Fpa, Aa^Fpa, Aa^Fpa, Rb, Rb, Rb, Rb, Aa^Fpa, Rb, Rb, Rb, Aa^Fpa, Aa^Fpa, Aa^Fpa, Aa^Fpa, Ms^Xm, Ms^Xm, Aa, Aa, Aa, Aa, Aa, Aa, Aa, Aa, Aa, Aa, Aa, Aa, Aa, Aa, Aa
Ms^Xm, Ms^Xm, Aa, Aa, Ms^Xm, Aa^Fpa, Aa^Fpa, Aa^Fpa, Aa^Fpa, Aa^Fpa, Rb, Rb, Rb, Rb, Rb, Rb, Aa^Fpa, Aa^Fpa, Aa^Fpa, Aa^Fpa, Aa^Fpa, Aa^Fpa, Ms^Xm, Aa, Aa, Aa, Aa, Aa, Aa, Aa, Aa, Aa, Aa, Aa, Aa, Aa, Aa, Aa
Ms^Xm, Ms^Xm, Aa, Aa, Aa, Ms^Xm, Ms^Xm, Aa^Fpa, Rb, Aa^Fpa, Rb, Aa^Fpa, Aa^Fpa, Aa^Fpa, Aa^Fpa, Aa^Fpa, Aa^Fpa, Aa^Fpa, Aa^Fpa, Aa^Fpa, Aa^Fpa, Aa^Fpa, Ms^Xm, Aa, Aa, Aa, Aa, Aa, Aa, Aa, Aa, Aa, Aa, Aa, Aa, Aa, Aa, Aa
Ms^Xm, Ms^Xm, Ms^Xm, Aa, Aa, Ms^Xm, Aa^Fpa, Aa^Fpa, Rb, Rb, Aa, Aa, Aa, Aa^Fpa, Aa^Fpa, Aa^Fpa, Aa^Fpa, Aa^Fpa, Aa^Fpa, Aa^Fpa, Aa^Fpa, Ms^Xm, Aa, Aa, Aa, Aa, Aa, Aa, Aa, Aa, Aa, Aa, Aa, Aa, Aa, Aa, Aa, Aa
Ms^Xm, Ms^Xm, Ms^Xm, Ms^Xm, Ms^Xm, Ms^Xm, Aa^Fpa, Rb, Aa, Aa, Aa, Aa, Aa, Aa^Fpa, Aa^Fpa, Aa^Fpa, Aa^Fpa, Aa^Fpa, Ms^Xm, Ms^Xm, Ms^Xm, Ms^Xm, Aa, Aa, Aa, Aa, Aa, Aa, Aa, Aa, Aa, Aa, Aa, Aa, Aa, Aa, Aa, Aa
Ms^Xm, Aa, Ms^Xm, Ms^Xm, Ms^Xm, Ms^Xm, Aa^Fpa, Rb, Rb, Aa, Aa, Aa, Aa, Aa^Fpa, Aa^Fpa, Aa^Fpa, Aa^Fpa, Ms^Xm, Aa, Aa, Aa, Aa, Aa, Aa, Aa, Aa, Aa, Aa, Aa, Aa, Aa, Aa, Aa, Aa, Aa, Aa, Aa, Aa
Ms^Xm, Aa, Ms^Xm, Aa^Fpa, Aa^Fpa, Aa^Fpa, Aa^Fpa, Aa^Fpa, Aa^Fpa, Rb, Aa, Aa, Aa^Fpa, Aa^Fpa, Aa^Fpa, Aa^Fpa, Aa^Fpa, Ms^Xm, Ms^Xm, Aa, Aa, Aa, Aa, Aa, Aa, Aa, Aa, Aa, Aa, Aa, Aa, Aa, Aa, Aa, Aa, Aa, Aa, Aa
Ms^Xm, Aa, Aa, Ms^Xm, Aa^Fpa, Aa^Fpa, Aa^Fpa, Aa^Fpa, Aa^Fpa, Rb, Rb, Rb, Rb, Aa^Fpa, Rb, Aa^Fpa, Aa^Fpa, Ms^Xm, Aa, Ms^Xm, Aa, Aa, Aa, Aa, Aa, Aa, Aa, Aa, Aa, Aa, Aa, Aa, Aa, Aa, Aa, Aa, Aa, Aa
Ms^Xm, Aa, Aa, Ms^Xm, Ms^Xm, Aa^Fpa, Ms^Xm, Ms^Xm, Ms^Xm, Ms^Xm, Ms^Xm, Rb, Aa^Fpa, Rb, Rb, Rb, Aa^Fpa, Ms^Xm, Aa, Ms^Xm, Ms^Xm, Aa, Aa, Aa, Aa, Aa, Aa, Aa, Aa, Aa, Aa, Aa, Aa, Aa, Aa, Aa, Aa, Aa
Ms^Xm, Aa, Aa, Ms^Xm, Ms^Xm, Ms^Xm, Ms^Xm, Ms^Xm, Aa, Ms^Xm, Ms^Xm, Ms^Xm, Aa^Fpa, Aa^Fpa, Rb, Aa^Fpa, Aa^Fpa, Ms^Xm, Ms^Xm, Ms^Xm, Ms^Xm, Aa, Aa, Aa, Aa, Aa, Aa, Aa, Aa, Aa, Aa, Aa, Aa, Aa, Aa, Aa, Aa, Aa
Ms^Xm, Aa, Aa, Aa, Aa, Aa, Aa, Aa, Aa, Aa, Aa, Ms^Xm, Ms^Xm, Aa^Fpa, Rb, Rb, Aa^Fpa, Aa^Fpa, Aa^Fpa, Ms^Xm, Aa^Fpa, Ms^Xm, Ms^Xm, Aa, Aa, Aa, Aa, Aa, Aa, Aa, Aa, Aa, Aa, Aa, Aa, Aa, Aa, Aa
Ms^Xm, Aa, Aa, Aa, Aa, Aa, Aa, Aa, Aa, Aa, Aa, Aa, Aa, Ms^Xm, Aa^Fpa, Rb, Aa, Aa^Fpa, Aa^Fpa, Aa^Fpa, Aa^Fpa, Aa^Fpa, Ms^Xm, Ms^Xm, Aa, Aa, Aa, Aa, Aa, Aa, Aa, Aa, Aa, Aa, Aa, Aa, Aa, Aa
Ms^Xm, Ms^Xm, Ms^Xm, Aa, Aa, Aa, Aa, Aa, Aa, Aa, Ms^Xm, Aa, Ms^Xm, Ms^Xm, Ms^Xm, Aa, Rb, Rb, Aa^Fpa, Aa^Fpa, Aa^Fpa, Aa^Fpa, Aa^Fpa, Ms^Xm, Ms^Xm, Aa, Aa, Aa, Aa, Aa, Aa, Aa, Aa, Aa, Aa, Aa, Aa, Aa
Ms^Xm, Ms^Xm, Ms^Xm, Ms^Xm, Aa, Aa, Aa, Aa, Aa, Aa, Aa, Ms^Xm, Aa, Aa, Ms^Xm, Aa^Fpa, Aa^Fpa, Rb, Rb, Aa^Fpa, Aa^Fpa, Aa^Fpa, Aa^Fpa, Aa^Fpa, Aa^Fpa, Ms^Xm, Ms^Xm, Aa, Aa, Aa, Aa, Aa, Aa, Aa, Aa, Aa, Aa, Aa
Ms^Xm, Ms^Xm, Ms^Xm, Ms^Xm, Aa, Aa, Aa, Aa, Aa, Aa, Ms^Xm, Aa, Ms^Xm, Aa, Aa, Ms^Xm, Ms^Xm, Aa^Fpa, Aa^Fpa, Rb, Rb, Aa^Fpa, Rb, Aa^Fpa, Aa^Fpa, Aa^Fpa, Ms^Xm, Aa, Aa, Aa, Aa, Aa, Aa, Aa, Aa, Aa, Aa, Aa
Ms^Xm, Ms^Xm, Ms^Xm, Ms^Xm, Aa, Aa, Aa, Aa, Ms^Xm, Ms^Xm, Ms^Xm, Ms^Xm, Ms^Xm, Ms^Xm, Ms^Xm, Aa, Ms^Xm, Aa^Fpa, Ms^Xm, Aa^Fpa, Aa^Fpa, Rb, Aa^Fpa, Rb, Rb, Aa^Fpa, Ms^Xm, Aa, Aa, Aa, Aa, Aa, Aa, Aa, Aa, Aa, Aa, Aa
Ms^Xm, Ms^Xm, Ms^Xm, Ms^Xm, Ms^Xm, Aa, Aa, Aa, Ms^Xm, Ms^Xm, Ms^Xm, Ms^Xm, Aa^Fpa, Ms^Xm, Ms^Xm, Aa, Aa, Ms^Xm, Ms^Xm, Ms^Xm, Ms^Xm, Aa^Fpa, Aa^Fpa, Aa^Fpa, Rb, Aa^Fpa, Aa^Fpa, Ms^Xm, Ms^Xm, Ms^Xm, Ms^Xm, Ms^Xm, Aa, Aa, Aa, Aa, Aa, Aa
Aa, Aa, Aa, Aa, Aa, Ms^Xm, Ms^Xm, Ms^Xm, Ms^Xm, Ms^Xm, Aa^Fpa, Ms^Xm, Ms^Xm, Aa^Fpa, Aa^Fpa, Ms^Xm, Aa, Aa, Ms^Xm, Ms^Xm, Ms^Xm, Aa^Fpa, Aa^Fpa, Aa^Fpa, Rb, Aa^Fpa, Aa^Fpa, Ms^Xm, Ms^Xm, Aa^Fpa, Aa^Fpa, Ms^Xm, Ms^Xm, Aa, Aa, Aa, Aa, Aa
Aa, Aa, Aa, Aa, Aa, Ms^Xm, Ms^Xm, Ms^Xm, Aa^Fpa, Aa^Fpa, Aa^Fpa, Ms^Xm, Ms^Xm, Aa^Fpa, Aa^Fpa, Ms^Xm, Ms^Xm, Ms^Xm, Aa, Ms^Xm, Ms^Xm, Aa^Fpa, Aa^Fpa, Aa^Fpa, Rb, Rb, Rb, Aa^Fpa, Aa^Fpa, Aa^Fpa, Aa, Aa^Fpa, Ms^Xm, Aa, Aa, Aa, Aa, Aa
Aa, Aa, Aa, Aa, Aa, Aa, Aa, Aa^Fpa, Aa^Fpa, Aa^Fpa, Aa^Fpa, Ms^Xm, Ms^Xm, Aa^Fpa, Aa^Fpa, Aa^Fpa, Ms^Xm, Aa, Aa, Aa, Ms^Xm, Ms^Xm, Ms^Xm, Aa^Fpa, Rb, Aa^Fpa, Aa^Fpa, Aa^Fpa, Aa^Fpa, Aa^Fpa, Aa^Fpa, Aa^Fpa, Ms^Xm, Aa, Aa, Aa, Aa, Aa
Aa, Aa, Aa, Aa, Cea, Cea, Cea, Rb, Rb, Rb, Rb, Rb, Rb, Rb, Rb, Aa^Fpa, Ms^Xm, Ms^Xm, Aa, Aa, Aa, Ms^Xm, Ms^Xm, Rb, Rb, Aa^Fpa, Aa^Fpa, Ms^Xm, Ms^Xm, Ms^Xm, Aa^Fpa, Ms^Xm, Ms^Xm, Aa, Aa, Aa, Aa, Aa
Aa, Aa, Aa, Aa, Cea, Kea, Cea, Aa^Fpa, Aa^Fpa, Rb, Aa^Fpa, Rb, Ms^Xm, Rb, Rb, Rb, Rb, Ms^Xm, Ms^Xm, Aa, Ms^Xm, Ms^Xm, Aa^Fpa, Aa, Aa, Ms^Xm, Ms^Xm, Ms^Xm, Aa, Ms^Xm, Ms^Xm, Ms^Xm, Aa, Aa, Aa, Aa, Aa, Aa
Ms^Xm, Ms^Xm, Ms^Xm, Rb, Rb, Cea, Aa^Fpa, Aa^Fpa, Aa^Fpa, Aa^Fpa, Ms^Xm, Ms^Xm, Ms^Xm, Aa^Fpa, Aa^Fpa, Rb, Aa, Aa^Fpa, Aa^Fpa, Ms^Xm, Aa^Fpa, Aa^Fpa, Rb, Rb, Rb, Ms^Xm, Aa^Fpa, Ms^Xm, Ms^Xm, Aa, Aa, Aa, Aa, Aa, Aa, Aa, Aa, Aa
Ms^Xm, Aa, Ms^Xm, Rb, Aa^Fpa, Aa^Fpa, Aa^Fpa, Aa^Fpa, Ms^Xm, Ms^Xm, Ms^Xm, Ms^Xm, Aa^Fpa, Aa^Fpa, Aa^Fpa, Aa, Rb, Aa^Fpa, Rb, Aa^Fpa, Aa^Fpa, Rb, Rb, Aa^Fpa, Aa^Fpa, Aa^Fpa, Aa^Fpa, Aa^Fpa, Ms^Xm, Ms^Xm, Aa, Aa, Aa, Aa, Aa, Aa, Aa, Aa
Ms^Xm, Ms^Xm, Aa^Fpa, Rb, Aa, Aa^Fpa, Aa^Fpa, Aa^Fpa, Ms^Xm, Ms^Xm, Ms^Xm, Aa^Fpa, Aa^Fpa, Aa^Fpa, Aa^Fpa, Aa^Fpa, Aa^Fpa, Rb, Rb, Rb, Rb, Rb, Rb, Aa^Fpa, Aa^Fpa, Aa^Fpa, Aa^Fpa, Aa^Fpa, Ms^Xm, Aa, Aa, Aa, Aa, Aa, Xos, Aa, Xos, Aa
Ms^Xm, Ms^Xm, Ms^Xm, Aa^Fpa, Aa^Fpa, Rb, Aa^Fpa, Aa^Fpa, Aa^Fpa, Ms^Xm, Ms^Xm, Aa^Fpa, Aa^Fpa, Aa^Fpa, Aa^Fpa, Aa^Fpa, Ms^Xm, Aa^Fpa, Aa^Fpa, Aa^Fpa, Aa^Fpa, Aa^Fpa, Aa^Fpa, Aa^Fpa, Aa^Fpa, Aa^Fpa, Ms^Xm, Ms^Xm, Aa, Aa, Aa, Aa, Xos, Xos, Irs, Xos, Irs, Xos
Aa, Aa, Ms^Xm, Ms^Xm, Aa^Fpa, Rb, Rb, Aa^Fpa, Aa^Fpa, Aa^Fpa, Ms^Xm, Ms^Xm, Aa^Fpa, Aa^Fpa, Ms^Xm, Ms^Xm, Ms^Xm, Ms^Xm, Aa^Fpa, Aa^Fpa, Cte, Cte, Cte, Aa^Fpa, Aa^Fpa, Aa^Fpa, Ms^Xm, Aa, Aa, Aa, Xos, Xos, Irs, Irs, Irs, Irs, Irs, Xos
Aa, Aa, Ms^Xm, Ms^Xm, Rb, Rb, Aa^Fpa, Aa^Fpa, Ms^Xm, Ms^Xm, Ms^Xm, Ms^Xm, Aa^Fpa, Ms^Xm, Ms^Xm, Ms^Xm, Ms^Xm, Ms^Xm, Ms^Xm, Aa^Fpa, Cte, Kte, Cte, Aa^Fpa, Ms^Xm, Ms^Xm, Aa, Aa, Aa, Xos, Irs, Irs, Xos, Irs, Irs, Irs, Irs, Xos
Ms^Xm, Ms^Xm, Ms^Xm, Aa^Fpa, Rb, Aa^Fpa, Ms^Xm, Ms^Xm, Ms^Xm, Ms^Xm, Ms^Xm, Aa^Fpa, Aa^Fpa, Ms^Xm, Ms^Xm, Aa, Ms^Xm, Ms^Xm, Ms^Xm, Aa^Fpa, Aa^Fpa, Cte, Aa^Fpa, Aa^Fpa, Ms^Xm, Aa, Aa, Aa, Xos, Xos, Irs, Xos, Xos, Irs, Xos, Irs, Xos, Xos
Ms^Xm, Ms^Xm, Rb, Rb, Aa^Fpa, Ms^Xm, Ms^Xm, Ms^Xm, Aa, Ms^Xm, Aa, Aa, Ms^Xm, Aa^Fpa, Ms^Xm, Aa, Xos, Xos, Xos, Aa^Fpa, Rb, Rb, Aa^Fpa, Aa^Fpa, Ms^Xm, Aa, Xos, Xos, Irs, Irs, Xos, Xos, Xos, Xos, Irs, Irs, Irs, Xos
Aa^Fpa, Aa^Fpa, Rb, Rb, Ms^Xm, Ms^Xm, Ms^Xm, Aa, Aa, Aa, Ms^Xm, Ms^Xm, Ms^Xm, Ms^Xm, Xos, Xos, Irs, Irs, Irs, Irs, Aa^Fpa, Aa^Fpa, Aa^Fpa, Aa^Fpa, Xos, Xos, Irs, Irs, Irs, Xos, Xos, Xos, Xos, Xos, Xos, Irs, Irs, Xos
Aa^Fpa, Aa^Fpa, Rb, Rb, Aa^Fpa, Ms^Xm, Ms^Xm, Aa, Ms^Xm, Ms^Xm, Ms^Xm, Ms^Xm, Qxu, Xos, Irs, Irs, Irs, Irs, Xos, Xos, Xos, Xos, Xos, Xos, Irs, Irs, Xos, Xos, Xos, Irs, Irs, Xos, Xos, Xos, Irs, Irs, Xos, Xos
Rb, Rb, Rb, Rb, Aa^Fpa, Aa^Fpa, Ms^Xm, Ms^Xm, Ms^Xm, Ms^Xm, Qxu, Qxu, Qxu, Xos, Xos, Irs, Irs, Irs, Irs, Irs, Irs, Irs, Irs, Irs, Irs, Irs, Irs, Irs, Xos, Irs, Irs, Irs, Irs, Irs, Irs, Xos, Xos, Xos
Aa^Fpa, Rb, Rb, Rb, Aa^Fpa, Aa^Fpa, Qxu, Ms^Xm, Ms^Xm, Ms^Xm, Qxu, Qxu, Qxu, Qxu, Qxu, Xos, Xos, Irs, Xos, Irs, Xos, Irs, Xos, Irs, Irs, Irs, Xos, Irs, Xos, Irs, Irs, Irs, Xos, Irs, Xos, Xos, Xos, Xos
Qxu, Aa^Fpa, Qxu, Rb, Qxu, Qxu, Qxu, Qxu, Qxu, Qxu, Qxu, Qxu, Qxu, Qxu, Qxu, Xos, Xos, Xos, Xos, Xos, Xos, Xos, Xos, Xos, Xos, Irs, Irs, Xos, Irs, Irs, Xos, Xos, Xos, Xos, Xos, Xos, Xos, Xos
Qxu, Qxu, Qxu, Qxu^Bh|, Qxu, Qxu, Qxu, Qxu, Qxu, Qxu, Qxu, Qxu, Qxu, Qxu, Qxu, Xos, Xos, Xos, Xos, Xos, Xos, Xos, Xos, Xos, Xos, Xos, Xos, Irs, Irs, Xos, Xos, Xos, Xos, Xos, Xos, Xos, Xos, Xos
Qxu, Qxu, Qxu, Qxu^Bh|, Qxu, Qxu, Qxu, Qxu, Qxu, Qxu, Qxu, Qxu, Qxu, Qxu, Qxu, Xos, Xos, Xos, Xos, Xos, Xos, Xos, Xos, Xos, Xos, Xos, Xos, Xos, Xos, Xos, Xos, Xos, Xos, Xos, Xos, Xos, Xos, Xos
