Xu, Xu, Xu, Xu, Xu, Xu, Xu, Xu, Xu, Xu, Qxu, Xu, Xu, Xu, Xu, Xu, Xu, Xu, Xu, Xu, Xu, Xu, Xu, Xu, Xu, Xu, Xu, Xu, Xu, Xu, Xu, Xu, Xu, Xu
Xu, Xu, Xu, Xu, Xu, Xu, Xu, Xu, Xu, Qxu, Qxu, Qxu, Qxu, Xu, Xu, Xu, Xu, Xu, Xu, Xu, Xu, Xu, Qxu, Qxu, Qxu, Qxu, Qxu, Xu, Xu, Xu, Xu, Xu, Xu, Xu
Ai, Xu, Xu, Xu, Xu, Xu, Xu, Xu, Xu, Qxu, Ai, Qxu, Qxu, Qxu, Qxu, Xu, Qxu, Xu, Xu, Xu, Qxu, Qxu, Qxu, Qxu, Qxu, Qxu, Qxu, Qxu, Xu, Xu, Xu, Xu, Xu, Xu
Ai, Xu, Xu, Xu, Xu, Xu, Ai, Xu, Xu, Ai, Ai, Ai, Ai, Qxu, Qxu, Qxu, Qxu, Qxu, Qxu, Qxu, Qxu, Qxu, Ai, Ai, Ai, Ai, Qxu, Qxu, Xu, Xu, Xu, Xu, Xu, Xu
Ai, Xu, Ur, Xu, Cea, Xu, Cea, Xu, Ur, Ai, Xu, Ai, Ur, Ai, Ur, Qxu, Ur, Qxu, Qxu, Qxu, Ai, Qxu, Cha, Cha, Cha, Qxu, Qxu, Qxu, Xu, Xu, Xu, Xu, Xu, Xu
Ai, Ai, Ur, Cea, Cea, Kea, Cea, Cea, Ur, Ur, Xu, Xu, Ur, Ur, Qxu, Ur, Ai, Ur, Ur, Qxu, Ur, Ai, Cha, Kha, Cha, Qxu, Qxu, Qxu, Xu, Xu, Xu, Xu, Xu, Xu
Ai, Xu, Ai, Xu, Xu, Xu, Xu, Xu, Xu, Ur, Ai, Ai, Qxu, Qxu, Qxu, Qxu, Qxu, Ai, Qxu, Ur, Ur, Ai, Ai, Cha, Ai, Ai, Qxu, Qxu, Xu, Xu, Xu, Xu, Xu, Xu
Xu, Xu, Ai, Xu, Xu, Xu, Xu, Xu, Qxu, Ur, Ai, Ai, Qxu, Qxu, Xu, Qxu, Qxu, Qxu, Qxu, Qxu, Qxu, Qxu, Ai, Ai, Qxu, Qxu, Qxu, Qxu, Xu, Xu, Xu, Xu, Xu, Xu
Ai, Ai, Xu, Xu, Xu, Xu, Xu, Xu, Qxu, Qxu, Qxu, Qxu, Qxu, Qxu, Qxu, Xu, Xu, Qxu, Xu, Qxu, Qxu, Qxu, Qxu, Ai, Qxu, Qxu, Xu, Xu, Xu, Xu, Xu, Xu, Xu, Xu
Ai, Ai, Xu, Xu, Xu, Xu, Xu, Xu, Qxu, Qxu, Qxu, Qxu, Ai, Qxu, Qxu, Qxu, Qxu, Qxu, Qxu, Xu, Qxu, Qxu, Ur, Ai, Qxu, Qxu, Qxu, Xu, Xu, Xu, Xu, Xu, Xu, Xu
Ai, Ai, Xu, Xu, Xu, Xu, Xu, Xu, Qxu, Qxu, Cha, Ai, Qxu, Ai, Ai, Qxu, Qxu, Qxu, Qxu, Qxu, Qxu, Qxu, Ur, Ai, Ai, Qxu, Qxu, Qxu, Xu, Xu, Xu, Xu, Xu, Xu
Xu, Xu, Xu, Xu, Xu, Xu, Qxu, Qxu, Qxu, Qxu, Cha, Qxu, Qxu, Qxu, Qxu, Ai, Ur, Ur, Ai, Qxu, Ur, Ur, Ur, Ai, Ai, Ai, Qxu, Qxu, Xu, Xu, Xu, Xu, Xu, Xu
Xu, Xu, Xu, Xu, Xu, Xu, Qxu, Qxu, Cha, Qxu, Kha, Cha, Qxu, Qxu, Qxu, Qxu, Ai, Ai, Qxu, Ai, Qxu, Ur, Ai, Xu, Ai, Ai, Qxu, Qxu, Xu, Xu, Xu, Xu, Xu, Xu
Xu, Xu, Xu, Xu, Xu, Xu, Qxu, Qxu, Qxu, Cha, Xu, Cha, Xu, Qxu, Qxu, Qxu, Qxu, Qxu, Qxu, Qxu, Qxu, Qxu, Ai, Ai, Ai, Ai, Qxu, Qxu, Xu, Xu, Xu, Xu, Xu, Xu
Xu, Xu, Xu, Xu, Xu, Xu, Xu, Qxu, Qxu, Qxu, Xu, Ai, Xu, Xu, Xu, Qxu, Qxu, Qxu, Xu, Qxu, Qxu, Qxu, Ai, Ai, Ai, Qxu, Qxu, Qxu, Xu, Xu, Xu, Xu, Xu, Xu
Xu, Xu, Xu, Xu, Xu, Xu, Xu, Xu, Xu, Qxu, Xu, Ai, Xu, Xu, Xu, Xu, Xu, Xu, Xu, Xu, Qxu, Qxu, Qxu, Ai, Qxu, Qxu, Qxu, Xu, Xu, Xu, Xu, Xu, Xu, Xu
Xu, Xu, Xu, Xu, Xu, Xu, Xu, Xu, Xu, Xu, Xu, Ai, Xu, Xu, Xu, Xu, Xu, Xu, Xu, Xu, Xu, Qxu, Qxu, Qxu, Qxu, Qxu, Xu, Xu, Xu, Xu, Xu, Xu, Xu, Xu
Xu, Xu, Xu, Xu, Xu, Xu, Xu, Xu, Xu, Xu, Xu, Ai, Xu, Xu, Xu, Xu, Xu, Xu, Xu, Xu, Xu, Xu, Xu, Qxu, Xu, Xu, Xu, Xu, Xu, Xu, Qxu, Xu, Xu, Xu
Xu, Xu, Xu, Xu, Xu, Xu, Xu, Xu, Xu, Xu, Xu, Ai, Xu, Xu, Xu, Xu, Xu, Xu, Xu, Xu, Xu, Xu, Xu, Xu, Xu, Xu, Xu, Xu, Xu, Xu, Qxu, Xu, Xu, Xu
