Qxu, Qxu, Qxu, Qxu, Xoa, Xoa, Xoa, Xoa, Xoa, Qxu, Qxu, Qxu, Qxu, Qxu
Qxu, Qxu, Xoa, Xoa, Xoa, Xoa, Xoa, Xoa, Xoa, Xoa, Xoa, Qxu, Qxu, Qxu
Qxu, Qxu, Xoa, Xoa, Ias, Ias, Ias, Ias, Ias, Xoa, Xoa, Qxu, Qxu, Qxu
Qxu, Qxu, Xoa, Xoa, Ias, Ias, Ias, Ias, Ias, Xoa, Xoa, Qxu, Qxu, Qxu
Qxu, Qxu, Xoa, Xoa, Ias, Ias, Ias, Ias, Ias, Xoa, Xoa, Qxu, Qxu, Qxu
Qxu, Qxu, Xoa, Xoa, Xoa, Ias, Ias, Ias, Xoa, Xoa, Xoa, Qxu, Qxu, Qxu
Qxu, Qxu, Qxu, Xoa, Xoa, Xoa, Xoa, Xoa, Xoa, Xoa, Xoa, Xoa, Qxu, Qxu
Qxu, Qxu, Qxu, Xoa, Xoa, Ias, Ias, Ias, Xoa, Ias, Xoa, Xoa, Qxu, Qxu
Qxu, Qxu, Qxu, Xoa, Xoa, Ias, Ias, Ias, Xoa, Xoa, Xoa, Xoa, Qxu, Qxu
Qxu, Qxu, Qxu, Xoa, Xoa, Ias, Ias, Ias, Xoa, Xoa, Qxu, Qxu, Qxu, Qxu
Qxu, Qxu, Xoa, Xoa, Xoa, Ias, Ias, Ias, Xoa, Xoa, Qxu, Qxu, Qxu, Qxu
Qxu, Xoa, Xoa, Xoa, Xoa, Xoa, Xoa, Xoa, Xoa, Xoa, Qxu, Qxu, Qxu, Qxu
Qxu, Xoa, Xoa, Ias, Xoa, Ias, Ias, Ias, Xoa, Xoa, Qxu, Qxu, Qxu, Qxu
Qxu, Xoa, Xoa, Xoa, Xoa, Ias, Ias, Ias, Xoa, Xoa, Qxu, Qxu, Qxu, Qxu
Qxu, Qxu, Qxu, Xoa, Xoa, Ias, Ias, Ias, Xoa, Xoa, Qxu, Qxu, Qxu, Qxu
Qxu, Qxu, Qxu, Xoa, Xoa, Ias, Ias, Ias, Xoa, Xoa, Qxu, Qxu, Qxu, Qxu
Qxu, Qxu, Qxu, Xoa, Xoa, Xoa, Xoa, Xoa, Xoa, Xoa, Qxu, Qxu, Qxu, Qxu
Qxu, Qxu, Qxu, Xoa, Xoa, Ias, Ias, Ias, Xoa, Xoa, Qxu, Qxu, Qxu, Qxu
Qxu, Qxu, Qxu, Xoa, Xoa, Ias, Ias, Ias, Xoa, Xoa, Qxu, Qxu, Qxu, Qxu
Qxu, Qxu, Qxu, Xoa, Xoa, Ias, Ias, Ias, Xoa, Xoa, Qxu, Qxu, Qxu, Qxu
Qxu, Qxu, Qxu, Xoa, Xoa, Ias, Ias, Ias, Xoa, Xoa, Qxu, Qxu, Qxu, Qxu
Qxu, Qxu, Qxu, Xoa, Xoa, Xoa, Ias, Xoa, Xoa, Xoa, Qxu, Qxu, Qxu, Qxu
Qxu, Qxu, Qxu, Qxu, Xoa, Xoa, Ias, Xoa, Xoa, Qxu, Qxu, Qxu, Qxu, Qxu
Qxu, Qxu, Xu, Xu, Xu, Xoa, Ias, Xoa, Xu, Xu, Xu, Qxu, Qxu, Qxu
Xu, Xu, Xu, Xu, Uu^Edt, Uu^Edt, Ias, Xoa, Uu^Edt, Xu, Xu, Xu, Xu, Qxu
Xu, Xu, Qxu, Uu^Edt, Uu^Edt, Uu^Edt, Ias, Uu^Edt, Uu^Edt, Uu^Edt, Uu^Edt, Xu, Xu, Xu
Qxu, Qxu, Qxu, Uu^Edt, Uu^Edt, Uu^Edt, Ias, Uu^Edt, Uu^Edt, Uu^Edt, Uu^Edt, Qxu, Qxu, Xu
Qxu, Qxu, Uu^Edt, Uu^Edt, Uu^Edt, Uu^Edt, Ias, Uu^Edt, Uu^Edt, Uu^Edt, Uu^Edt, Uu^Edt, Qxu, Qxu
Qxu, Qxu, Uu^Edt, Uu^Edt, Uu^Edt, Uu^Edt, Uu^Edt, Uu^Edt, Uu^Edt, Uu^Edt, Uu^Edt, Qxu, Qxu, Qxu
Qxu, Qxu, Qxu, Uu^Edt, Uu^Edt, Uu^Edt, Uu^Edt, Uu^Edt, Uu^Edt, Uu^Edt, Qxu, Qxu, Qxu, Qxu
Qxu, Qxu, Qxu, Uu^Edt, Uu^Edt, Uu^Edt, Uu^Edt, Uu^Edt, Uu^Edt, Uu^Edt, Qxu, Qxu, Qxu, Qxu
Qxu, Qxu, Qxu, Qxu, Uu^Edt, Uu^Edt, Uu^Edt, Uu^Edt, Uu^Edt, Uu^Edt, Qxu, Qxu, Qxu, Qxu
Qxu, Qxu, Qxu, Qxu, Qxu, Uu^Edt, Uu^Edt, Uu^Edt, Uu^Edt, Uu^Edt, Qxu, Qxu, Qxu, Qxu
Qxu, Qxu, Qxu, Qxu, Uu^Edt, Uu^Edt, Uu^Edt, Uu^Edt, Uu^Edt, Qxu, Qxu, Qxu, Qxu, Qxu
Qxu, Qxu, Qxu, Qxu, Qxu, Uu^Edt, Uu^Edt, Uu^Edt, Uu^Edt, Uu^Edt, Qxu, Qxu, Qxu, Qxu
Qxu, Qxu, Qxu, Qxu, Qxu, Qxu, Ce, Uu^Edt, Ce, Qxu, Qxu, Qxu, Qxu, Qxu
Qxu, Qxu, Qxu, Qxu, Qxu, Uu, Ce, Ke, Ce, Qxu, Qxu, Qxu, Qxu, Qxu
Qxu, Qxu, Qxu, Qxu, Qxu, Qxu, Uu, Qxu, Uu, Qxu, Qxu, Qxu, Qxu, Qxu
Qxu, Qxu, Qxu, Qxu, Qxu, Qxu, Uu, Uu, Qxu, Uu, Uu, Qxu, Qxu, Qxu
