Sm, Sm, Sm, Sm, Sm, Sm, Sm, Sm, Sm, Sm, Sm, Sm, Sm, Sm, Sm, Sm, Sm, Sm, Sm, Sm, Sm, Sm, Sm, Sm, Sm, Sm, Sm, Sm, Sm, Sm, Sm, Sm^Bw|r, Sm, Sm, Sm, Sm, Sm, Sm, Sm, Sm, Sm, Sm
Sm, Sm, Sm, Sm, Sm, Sm, Sm, Sm, Sm, Sm, Sm, Sm, Sm, Sm, Sm, Sm, Sm, Sm, Sm, Sm, Sm, Sm, Sm, Sm, Sm, Sm, Sm, Sm, Sm, Sm, Hh, Sm^Bw|r, Sm, Sm, Sm, Sm, Sm, Sm, Sm, Sm, Sm, Sm
Sm, Sm, Sm, Sm, Sm, Sm, Sm, Sm, Sm, Sm, Sm, Sm, Sm, Sm, Sm, Sm, Sm, Sm, Sm, Sm, Sm, Sm, Sm, Sm, Sm, Sm, Sm, Sm, Hh, Hh, Ce^Ebn, Gg, Ce, Hh, Gg, Sm, Sm, Sm, Sm, Sm, Sm, Mv
Sm, Sm, Sm, Sm, Sm, Sm, Sm, Sm, Sm, Sm, Sm, Sm, Sm, Sm, Sm, Sm, Sm, Sm, Sm, Sm, Sm, Sm, Sm, Sm, Sm, Sm, Sm, Sm, Hh, Gg, Ce, Ke, Ce, Gg, Sm, Sm, Sm, Sm, Sm, Sm, Sm, Sm
Sm, Sm, Sm, Sm, Sm, Sm, Sm, Sm, Sm, Sm, Sm, Sm, Sm, Sm, Sm, Sm^Vhs, Sm, Sm, Sm, Sm, Sm, Sm, Sm, Sm, Sm, Hh^Ebn, Sm^Bw/r, Sm^Bw\r, Gg^Ebn, Gg, Gg^Vhs, Gg, Hh, Sm, Sm, Sm, Sm, Sm, Sm, Sm, Sm, Sm
Sm, Sm, Sm, Sm, Sm, Sm, Sm, Sm, Sm, Sm, Sm, Sm, Sm, Sm, Sm, Sm^Bw|r, Sm, Sm, Sm, Sm, Sm^Vhs, Sm, Sm, Sm, Hh, Gg, Gg, Sm, Gg, Gg, Gg, Gg, Sm, Sm, Sm, Sm, Sm, Sm, Sm, Sm, Sm, Sm
Sm, Sm, Sm, Sm, Sm, Sm, Sm, Sm, Sm, Sm, Sm, Sm, Sm, Sm^Vhs, Sm^Bw\r, Sm^Bw|r, Sm, Sm^Bw|r, Sm, Sm^Bw/r, Sm, Sm, Hh, Sm, Gg, Gg, Gg, Sm, Sm, Gg, Sm, Sm, Sm, Sm, Sm, Sm, Sm, Sm, Sm, Sm, Sm, Sm
Sm, Sm, Sm, Sm, Sm, Sm, Sm, Sm, Sm, Sm, Sm, Sm, Sm, Sm, Sm, Sm^Bw\r, Sm^Bw/r, Sm^Bw|r, Sm^Bw\r, Sm^Bw|r, Sm^Bw/r, Sm^Bw/r, Gg^Ebn, Hh, Sm, Hh, Sm, Sm, Sm, Sm, Sm, Sm, Sm, Sm, Sm, Sm, Sm, Sm, Sm, Sm, Sm, Sm
Sm, Sm, Sm, Sm, Sm, Sm, Sm, Sm, Sm, Sm, Sm, Sm, Hh, Hh, Sm, Sm, Gg, Sm^Bw|r, Sm, Sm, Sm, Sm, Sm, Sm, Sm, Hh, Sm, Sm, Sm, Sm, Sm, Sm, Sm, Sm, Sm, Sm, Sm, Sm, Sm, Sm, Sm, Sm
Sm, Sm, Sm, Sm, Sm, Sm, Mv, Sm, Sm, Sm, Sm, Hh, Gg^Vhs, Gg, Hh, Hh, Gg, Gg^Ebn, Sm, Gg, Hh, Hh, Gg, Sm, Cte, Gg, Cte, Sm, Sm, Sm, Sm, Sm, Sm, Mv, Sm, Sm, Sm, Sm, Sm, Sm, Sm, Sm
Sm, Sm, Sm, Sm, Sm, Sm, Sm, Sm, Sm, Sm, Sm, Gg, Hh, Hh, Sm, Gg, Gg, Sm, Gg, Hh, Hh, Hh, Hh, Hh, Sm, Kte, Sm, Sm, Sm, Sm, Sm, Sm, Sm, Sm, Sm, Sm, Sm, Sm, Sm, Sm, Sm, Sm
Sm, Sm, Sm, Sm, Sm, Sm, Sm, Sm, Sm, Sm, Sm, Hh, Sm, Sm, Sm, Gg^Ebn, Sm^Bw|r, Sm, Sm, Gg^Fetd, Sm, Hh, Sm, Sm, Sm, Sm, Sm, Sm, Sm, Sm, Sm, Sm, Sm, Sm, Sm, Sm, Sm, Sm, Sm, Sm, Sm, Sm
Sm, Sm, Sm, Sm, Sm, Sm, Sm, Sm, Sm, Sm, Sm, Sm, Sm, Sm, Sm, Sm, Sm^Bw|r, Sm, Sm, Sm, Sm, Sm, Sm, Sm, Sm, Sm, Sm, Sm, Sm, Sm, Sm, Sm, Sm, Sm, Sm, Hh, Hh, Sm, Sm, Sm, Sm, Sm
Sm, Sm, Sm, Sm, Sm, Sm, Sm, Sm, Sm, Sm, Sm, Sm, Sm, Sm, Sm, Sm, Sm^Bw|r, Sm^Bw\r, Ket^Vhs, Sm, Sm, Sm, Sm, Sm, Sm, Sm, Sm, Sm, Sm, Sm, Sm, Sm, Sm, Sm, Gg, Gg, Gg, Sm, Sm, Sm, Sm, Sm
Sm, Sm, Sm, Sm, Sm, Sm, Sm, Sm, Sm, Sm, Sm, Sm, Sm, Sm, Sm, Sm, Sm^Bw|r, Sm, Sm, Sm, Sm, Sm, Sm, Sm, Sm, Sm, Sm, Sm, Mv, Sm, Sm, Sm, Sm, Hh, Gg^Fetd, Gg^Fetd, Gg, Sm, Sm, Sm, Sm, Sm
Sm, Sm, Sm, Sm, Sm, Sm, Sm, Sm, Sm, Sm, Sm, Sm, Sm, Sm, Gg, Sm, Gg, Sm, Hh, Sm, Sm, Sm, Sm, Sm, Sm, Sm, Sm, Sm, Sm, Sm, Sm, Sm, Sm, Sm, Gg, Gg, Gg, Sm, Sm, Sm, Sm, Sm
Sm, Sm, Sm, Sm, Sm, Sm, Sm, Sm, Sm, Sm, Sm, Sm, Gg, Gg, Gg, Gg, Gg, Gg, Hh, Gg, Hh, Gg, Hh, Sm, Sm, Sm, Sm, Sm, Sm, Sm, Sm, Sm, Sm, Sm, Sm, Gg, Sm, Sm, Sm, Sm, Sm, Mm^Xm
Sm, Sm, Sm, Sm, Sm, Sm, Sm, Sm, Sm, Sm, Sm, Sm, Hh, Gg, Sm, Gg^Ebn, Gg, Hh, Gg, Hh, Hh, Hh, Sm, Sm, Hh, Sm, Sm, Sm, Sm, Sm, Sm, Sm, Sm, Sm, Sm, Sm, Sm, Sm, Mm^Xm, Sm, Mm^Xm, Mm^Xm
Sm, Sm, Sm, Sm, Sm, Sm, Sm, Sm, Sm, Sm, Sm, Sm, Hh, Gg, Sm, Sm, Hh, Gg, Gg, Gg, Hh, Hh, Hh, Sm, Hh, Hh, Hh, Hh, Hh, Sm, Sm, Sm, Sm, Sm, Sm, Sm, Sm, Mm^Xm, Mm^Xm, Mm^Xm, Mm^Xm, Mm^Xm
Sm, Sm, Sm, Sm, Sm, Sm, Sm, Sm, Sm, Sm, Gg, Hh, Hh, Hh, Sm, Sm, Gg^Ebn, Gg^Ebn, Hh, Gg, Gg, Gg, Hh, Sm, Hh, Gg, Gg, Hh, Hh, Hh, Sm, Sm, Sm, Sm, Sm, Sm, Mm^Xm, Mm^Xm, Mm^Xm, Mm^Xm, Mm^Xm, Mm^Xm
Sm, Sm, Sm, Sm, Sm, Sm, Sm, Sm, Sm, Sm, Gg^Fetd, Hh, Hh, Hh, Sm, Sm, Gg, Gg, Sm, Sm, Sm, Gg, Gg, Sm, Gg, Gg, Hh, Gg, Gg, Hh, Hh, Hh, Gg, Sm, Sm, Sm, Mm^Xm, Mm^Xm, Mm^Xm, Mm^Xm, Mm^Xm, Mm^Xm
Sm, Sm, Sm, Sm, Sm, Sm, Sm, Sm, Sm, Sm, Sm, Hh, Sm, Gg, Gg, Gg^Ebn, Hh, Gg, Sm, Sm, Sm, Sm, Sm, Sm, Hh, Hh, Hh, Gg, Gg, Gg, Hh, Gg^Fetd, Sm, Sm, Sm, Sm, Mm^Xm, Mm^Xm, Mm^Xm, Mm^Xm, Mm^Xm, Mm^Xm
Sm, Sm, Sm, Sm, Sm, Sm, Sm, Sm, Sm, Sm, Sm, Sm, Sm, Sm, Gg, Gg, Hh^Ebn, Sm, Sm, Sm, Gg, Sm, Sm, Sm, Hh, Gg, Gg, Hh, Hh, Gg, Gg, Hh, Sm, Sm, Sm, Sm, Mm^Xm, Mm^Xm, Mm^Xm, Mm^Xm, Mm^Xm, Mm^Xm
Sm, Sm, Sm, Sm, Sm, Sm, Sm, Sm, Sm, Sm, Sm, Sm, Sm, Sm, Sm, Gg, Gg, Sm, Hh, Hh, Gg, Hh, Sm, Sm, Hh, Gg, Gg, Gg, Sm, Hh, Gg, Hh, Gg, Gg, Gg, Mm^Xm, Mm^Xm, Mm^Xm, Mm^Xm, Mm^Xm, Mm^Xm, Mm^Xm
Sm, Sm, Sm, Sm, Sm, Sm, Sm, Sm, Sm, Sm, Sm, Sm, Sm, Sm, Sm, Gg, Gg, Gg, Gg, Hh^Ebn, Gg, Gg, Gg, Gg, Gg, Gg, Gg, Gg, Hh, Sm, Gg, Gg, Gg, Gg, Gg, Mm^Xm, Mm^Xm, Mm^Xm, Mm^Xm, Mm^Xm, Mm^Xm, Mm^Xm
Sm, Sm, Sm, Sm, Sm, Sm, Sm, Sm, Sm, Sm, Sm, Sm, Sm, Sm, Sm, Hh, Hh, Gg, Sm, Sm, Hh, Gg^Ebn, Gg, Gg, Gg, Gg, Gg^Ebn, Hh, Gg, Gg, Gg, Gg, Gg, Gg, Hh, Mm^Xm, Mm^Xm, Mm^Xm, Mm^Xm, Mm^Xm, Mm^Xm, Mm^Xm
Sm, Sm, Sm, Sm, Sm, Sm, Sm, Sm, Sm, Sm, Sm, Sm, Sm, Sm, Sm, Sm, Gg, Sm, Gg, Hh, Gg, Gg, Gg, Gg, Gg^Ebn, Gg, Gg, Rb, Rb, Gg, Gg, Gg, Gg, Gg, Md^Xm, Mm^Xm, Mm^Xm, Mm^Xm, Mm^Xm, Mm^Xm, Mm^Xm, Mm^Xm
Sm, Sm, Sm, Sm, Sm, Sm, Sm, Sm, Sm, Sm, Sm, Sm, Sm, Sm, Sm, Sm, Gg, Gg, Hh, Gg, Hh, Hh, Sm, Gg, Gg, Gg, Gg, Gg, Gg, Rb^Feth, Gg, Gg, Gg, Gg, Md^Xm, Mm^Xm, Mm^Xm, Mm^Xm, Mm^Xm, Mm^Xm, Mm^Xm, Mm^Xm
Xu, Sm, Sm, Sm, Sm, Sm, Sm, Sm, Sm, Sm, Sm, Sm, Sm, Sm, Sm, Sm, Gg^Fetd, Gg, Sm, Sm, Sm, Sm, Sm, Sm, Hh, Gg, Gg, Gg, Gg, Gg, Gg, Gg, Gg, Hh, Md^Xm, Mm^Xm, Mm^Xm, Mm^Xm, Mm^Xm, Mm^Xm, Mm^Xm, Mm^Xm
Xu, Xu, Xu, Sm, Sm, Sm, Sm, Sm, Sm, Sm, Sm, Hh, Sm, Sm, Sm, Sm, Sm, Gg, Sm, Sm, Sm, Sm, Sm, Sm, Hh, Gg, Sm, Gg, Gg, Gg, Gg, Gg, Gg, Hh, Md^Xm, Mm^Xm, Mm^Xm, Mm^Xm, Mm^Xm, Mm^Xm, Mm^Xm, Mm^Xm
Xu, Xu, Xu, Xu, Xu, Sm, Sm, Sm, Sm, Sm, Sm, Sm, Sm, Sm, Sm, Sm, Sm, Sm, Sm, Sm, Sm, Sm, Sm, Sm, Hh, Gg, Sm, Sm, Gg, Gg, Gg, Gg, Gg, Hh, Md^Xm, Mm^Xm, Mm^Xm, Mm^Xm, Mm^Xm, Mm^Xm, Mm^Xm, Mm^Xm
Xu, Xu, Xu, Xu, Xu, Xu, Xu, Sm, Sm, Sm, Sm, Sm, Sm, Sm, Sm, Sm, Sm, Sm, Sm, Sm, Sm, Sm, Sm, Sm, Sm, Gg, Sm, Gg^Fetd, Gg, Gg^Fetd, Sm, Sm, Hh, Gg, Gg, Mm^Xm, Mm^Xm, Mm^Xm, Mm^Xm, Mm^Xm, Mm^Xm, Mm^Xm
Xu, Xu, Xu, Xu, Xu, Xu, Xu, Xu, Xu, Sm, Sm, Sm, Xu, Sm, Sm, Sm, Sm, Sm, Sm, Sm, Sm, Sm, Sm, Sm, Hh, Sm, Sm, Sm, Gg, Gg, Sm, Sm, Sm, Gg, Gg, Mm^Xm, Mm^Xm, Mm^Xm, Mm^Xm, Mm^Xm, Mm^Xm, Mm^Xm
Xu, Xu, Xu, Xu, Xu, Xu, Xu, Xu, Xu, Xu, Xu, Xu, Xu, Xu, Xu, Sm, Sm, Sm, Sm, Sm, Sm, Sm, Sm, Sm, Sm, Sm, Sm, Sm, Gg, Gg, Sm, Sm, Sm, Sm, Sm, Mm^Xm, Mm^Xm, Mm^Xm, Mm^Xm, Mm^Xm, Mm^Xm, Mm^Xm
Xu, Xu, Xu, Xu, Xu, Xu, Xu, Xu, Xu, Xu, Xu, Xu, Xoa, Xu, Xu, Xu, Xu, Sm, Sm, Sm, Sm, Sm, Sm, Sm, Sm, Sm, Sm, Hh, Gg, Gg, Hh, Sm, Sm, Sm, Sm, Sm, Sm, Mm^Xm, Sm, Mm^Xm, Mm^Xm, Mm^Xm
Xu, Xu, Xu, Xu, Xu, Xu, Xu, Xu, Xu, Xu, Xoa, Xoa, Ias, Xoa, Xoa, Xu, Xu, Xu, Sm, Sm, Sm, Sm, Sm, Sm, Sm, Sm, Sm, Sm, Gg, Gg, Sm, Sm, Sm, Sm, Sm, Sm, Sm, Sm, Sm, Sm, Sm, Mm^Xm
Xu, Xu, Xu, Xu, Xu, Xu, Xu, Xu, Xoa, Xoa, Ias, Ias, Ias, Ias, Ias, Xoa, Xu, Xu, Sm, Sm, Sm, Sm, Sm, Sm, Sm, Mv, Sm, Gg, Sm, Gg^Do, Sm, Sm, Sm, Sm, Sm, Sm, Sm, Sm, Sm, Sm, Sm, Sm
Xu, Xu, Xu, Xu, Xu, Xu, Xu, Xu, Xoa, Ias, Ias, Ias, Ias, Ias, Ias, Xoa, Xu, Xu, Sm, Sm, Sm, Sm, Sm, Sm, Sm, Sm, Sm, Sm, Sm, Hh, Sm, Sm, Sm, Sm, Gg, Hh, Hh, Sm, Hh, Sm, Sm, Sm
Xu, Xu, Xu, Xu, Xu, Xu, Xu, Xu, Xu, Xoa, Ias, Ias, Ias, Ias, Xoa, Xoa, Xu, Xu, Sm, Sm, Sm, Sm, Sm, Sm, Sm, Sm, Sm, Sm, Sm, Sm, Sm, Sm, Sm, Sm, Gg, Hh, Gg, Gg, Rb, Sm, Sm, Sm
Xu, Xu, Xu, Xu, Xu, Xu, Xu, Xu, Xu, Xu, Xoa, Ias, Ias, Ias, Xoa, Xu, Xu, Xu, Sm, Sm, Sm, Sm, Sm, Sm, Sm, Sm, Sm, Sm, Sm, Sm, Sm, Sm, Sm, Sm, Sm, Gg, Gg^Feth, Ias, Hh, Gg, Sm, Sm
Xu, Xu, Xu, Xu, Xu, Xu, Xu, Xu, Xu, Xu, Xoa, Ias, Ias, Xoa, Xoa, Xu, Xu, Xu, Xu, Sm, Sm, Sm, Sm, Sm, Sm, Sm, Sm, Sm, Sm, Sm, Sm, Sm, Sm, Sm, Sm, Sm, Sm, Gg, Sm, Sm, Sm, Sm
Xu, Xu, Xu, Xu, Xu, Xu, Xu, Xu, Xu, Xu, Xoa, Ias, Ias, Xoa, Xoa, Xu, Xu, Xu, Xu, Xu, Xu, Sm, Sm, Sm, Sm, Sm, Sm, Sm, Sm, Sm, Sm, Sm, Sm, Sm, Sm, Sm, Sm, Sm, Sm, Sm, Sm, Sm
Xu, Xu, Xu, Xu, Xu, Xu, Xu, Xu, Xu, Xu, Xoa, Ias, Ias, Xoa, Xoa, Xu, Xoa, Xu, Xoa, Xu, Xu, Xu, Xu, Sm, Sm, Sm, Sm, Sm, Sm, Sm, Sm, Sm, Sm, Sm, Sm, Sm, Sm, Sm, Sm, Sm, Sm, Sm
Xu, Xu, Xu, Xu, Xu, Xu, Xu, Xu, Xu, Xu, Xoa, Ias, Ias, Xoa, Ias, Xoa, Ias, Xoa, Ias, Xoa, Gg, Xu, Xu, Sm, Sm, Sm, Sm, Sm, Sm, Sm, Sm, Sm, Sm, Sm, Sm, Sm, Sm, Sm, Sm, Sm, Sm, Sm
Xu, Xu, Xu, Xu, Xu, Xu, Xu, Xu, Xu, Xu, Xoa, Ias, Ias, Ias, Xoa, Ias, Xoa, Ias, Xoa, Ias, Xu, Xu, Xu, Sm, Sm, Sm, Sm, Sm, Sm, Sm, Sm, Sm, Sm, Sm, Sm, Sm, Sm, Sm, Sm, Sm, Sm, Sm
Xu, Xu, Xu, Xu, Xu, Xu, Xu, Xu, Xu, Xu, Xu, Xoa, Xoa, Xoa, Xu, Xoa, Xu, Xoa, Xu, Xoa, Xu, Xu, Xu, Sm, Sm, Sm, Sm, Sm, Sm, Sm, Sm, Sm, Sm, Sm, Sm, Sm, Sm, Sm, Sm, Sm, Sm, Sm
Xu, Xu, Xu, Xu, Xu, Xu, Xu, Xu, Xu, Xu, Xu, Xu, Xu, Xu, Xu, Xu, Xu, Xu, Xu, Xu, Xu, Xu, Xu, Sm, Sm, Sm, Sm, Sm, Sm, Sm, Sm, Sm, Sm, Sm, Sm, Sm, Sm, Sm, Sm, Sm, Sm, Sm
Xu, Xu, Xu, Xu, Xu, Xu, Xu, Xu, Xu, Xu, Xu, Xu, Xu, Xu, Xu, Xu, Xu, Xu, Xu, Xu, Xu, Xu, Xu, Sm, Sm, Sm, Sm, Sm, Sm, Sm, Sm, Sm, Sm, Sm, Sm, Sm, Sm, Sm, Sm, Sm, Sm, Sm
Xu, Xu, Xu, Xu, Xu, Xu, Xu, Xu, Xu, Xu, Xu, Xu, Xu, Xu, Xu, Xu, Xu, Xu, Xu, Xu, Xu, Xu, Xu, Sm, Sm, Sm, Sm, Sm, Sm, Sm, Sm, Sm, Sm, Sm, Sm, Sm, Sm, Sm, Sm, Sm, Sm, Sm
Xu, Xu, Xu, Xu, Xu, Xu, Xu, Xu, Xu, Xu, Xu, Xu, Xu, Xu, Xu, Xu, Xu, Xu, Xu, Xu, Xu, Xu, Xu, Sm, Sm, Sm, Sm, Sm, Sm, Sm, Sm, Sm, Sm, Sm, Sm, Sm, Sm, Sm, Sm, Sm, Sm, Sm
Xu, Xu, Xu, Xu, Xu, Xu, Xu, Xu, Xu, Xu, Xu, Xu, Xu, Xu, Xu, Xu, Xu, Xu, Xu, Xu, Xu, Xu, Xu, Sm, Sm, Sm, Sm, Sm, Sm, Sm, Sm, Sm, Sm, Sm, Sm, Sm, Sm, Sm, Sm, Sm, Sm, Sm
Xu, Xu, Xu, Xu, Xu, Xu, Xu, Xu, Xu, Xu, Xu, Xu, Xu, Xu, Xu, Xu, Xu, Xu, Xu, Xu, Xu, Xu, Xu, Sm, Sm, Sm, Sm, Sm, Sm, Sm, Sm, Sm, Sm, Sm, Sm, Sm, Sm, Sm, Sm, Sm, Sm, Sm
