Hh^Zfx, Hh^Zfx, Hh^Zfx, Hh^Zfx, Hh^Zfx, Hh^Zfx, Hh^Zfx, Hh^Zfx, Hh^Zfx, Hh^Zfx, Hh^Zfx, Hh^Zfx, Hh^Zfx, Hh^Zfx, Hh^Zfx, Hh^Zfx, Hh^Zfx, Hh^Zfx, Hh^Zfx, Hh^Zfx
Hh^Zfx, Hh^Zfx, Hh^Zfx, Hh^Zfx, Hh^Zfx, Hh^Zfx, Hh^Zfx, Hh^Zfx, Hh^Zfx, Hh^Zfx, Hh^Zfx, Hh^Zfx, Hh^Zfx, Hh^Zfx, Hh^Zfx, Hh^Zfx, Hh^Zfx, Hh^Zfx, Hh^Zfx, Hh^Zfx
Hh^Zfx, Hh^Zfx, Hh^Zfx, Hh^Zfx, Hh^Zfx, Hh^Zfx, Hh^Zfx, Hh^Zfx, Hh^Zfx, Hh^Zfx, Gs^Fms, Hh^Zfx, Gs^Fms, Gs^Fms, Gs^Fms, Hh^Zfx, Hh^Zfx, Hh^Zfx, Hh^Zfx, Hh^Zfx
Hh^Zfx, Hh^Zfx, Hh^Zfx, Hh^Zfx, Hh^Zfx, Hh^Zfx, Hh^Zfx, Hh^Zfx, Gs^Fms, Gs^Fms, Gs^Fms, Gs^Fms, Gs^Fms, Gs^Fms, Gs^Fms, Gs^Fms, Gs^Fms, Hh^Zfx, Hh^Zfx, Hh^Zfx
Hh^Zfx, Hh^Zfx, Hh^Zfx, Hh^Zfx, Hh^Zfx, Hh^Zfx, Gs^Fms, Gs^Fms, Gs^Fms, Gs^Fms, Hh^Zfx, Gs^Fms, Gs^Fms, Gs^Fms, Gs^Fms, Gs^Fms, Gs^Fms, Hh^Zfx, Hh^Zfx, Hh^Zfx
Hh^Zfx, Hh^Zfx, Hh^Zfx, Hh^Zfx, Gs^Fms, Gs^Fms, Gs^Fms, Gs^Fms, Hh^Zfx, Hh^Zfx, Hh^Zfx, Hh^Zfx, Hh^Zfx, Gs^Fms, Gs^Fms, Gs^Fms, Gs^Fms, Hh^Zfx, Hh^Zfx, Hh^Zfx
Xu, Hh^Zfx, Xu, Hh^Zfx, Gs^Fms, Gs^Fms, Gs^Fms, Hh^Zfx, Hh^Zfx, Hh^Zfx, Hh^Zfx, Hh^Zfx, Hh^Zfx, Gs^Fms, Gs^Fms, Gs^Fms, Hh^Zfx, Hh^Zfx, Hh^Zfx, Hh^Zfx
Ur, Xu, Xu, Gs^Fms, Gs^Fms, Gs^Fms, Gs^Fms, Hh^Zfx, Hh^Zfx, Hh^Zfx, Hh^Zfx, Hh^Zfx, Hh^Zfx, Hh^Zfx, Gs^Fms, Gs^Fms, Hh^Zfx, Hh^Zfx, Hh^Zfx, Hh^Zfx
Ur, Ur, Rb, Gs^Fms, Gs^Fms, Gs^Fms, Gs^Fms, Hh^Zfx, Hh^Zfx, Hh^Zfx, Hh^Zfx, Hh^Zfx, Hh^Zfx, Hh^Zfx, Gs^Fms, Gs^Fms, Hh^Zfx, Hh^Zfx, Hh^Zfx, Hh^Zfx
Ur, Ur, Xu, Gs^Fms, Gs^Fms, Gs^Fms, Gs^Fms, Hh^Zfx, Hh^Zfx, Hh^Zfx, Hh^Zfx, Hh^Zfx, Hh^Zfx, Gs^Fms, Gs^Fms, Gs^Fms, Hh^Zfx, Hh^Zfx, Hh^Zfx, Hh^Zfx
Xu, Xu, Hh^Zfx, Hh^Zfx, Gs^Fms, Gs^Fms, Gs^Fms, Gs^Fms, Gs^Fms, Hh^Zfx, Hh^Zfx, Hh^Zfx, Gs^Fms, Gs^Fms, Gs^Fms, Gs^Fms, Hh^Zfx, Hh^Zfx, Hh^Zfx, Hh^Zfx
Hh^Zfx, Hh^Zfx, Hh^Zfx, Hh^Zfx, Gs^Fms, Gs^Fms, Gs^Fms, Gs^Fms, Gs^Fms, Gs^Fms, Gs^Fms, Gs^Fms, Gs^Fms, Gs^Fms, Gs^Fms, Gs^Fms, Hh^Zfx, Hh^Zfx, Hh^Zfx, Hh^Zfx
Hh^Zfx, Hh^Zfx, Hh^Zfx, Hh^Zfx, Hh^Zfx, Gs^Fms, Gs^Fms, Gs^Fms, Gs^Fms, Gs^Fms, Gs^Fms, Gs^Fms, Gs^Fms, Gs^Fms, Gs^Fms, Gs^Fms, Hh^Zfx, Hh^Zfx, Hh^Zfx, Hh^Zfx
Hh^Zfx, Hh^Zfx, Hh^Zfx, Hh^Zfx, Hh^Zfx, Gs^Fms, Gs^Fms, Gs^Fms, Gs^Fms, Gs^Fms, Gs^Fms, Gs^Fms, Gs^Fms, Gs^Fms, Hh^Zfx, Hh^Zfx, Hh^Zfx, Hh^Zfx, Hh^Zfx, Hh^Zfx
Hh^Zfx, Hh^Zfx, Hh^Zfx, Hh^Zfx, Gs^Fms, Gs^Fms, Gs^Fms, Gs^Fms, Hh^Zfx, Gs^Fms, Gs^Fms, Gs^Fms, Gs^Fms, Gs^Fms, Hh^Zfx, Hh^Zfx, Hh^Zfx, Hh^Zfx, Hh^Zfx, Hh^Zfx
Hh^Zfx, Hh^Zfx, Hh^Zfx, Hh^Zfx, Gs^Fms, Gs^Fms, Hh^Zfx, Hh^Zfx, Hh^Zfx, Hh^Zfx, Hh^Zfx, Gs^Fms, Gs^Fms, Gs^Fms, Hh^Zfx, Hh^Zfx, Hh^Zfx, Hh^Zfx, Hh^Zfx, Hh^Zfx
Hh^Zfx, Hh^Zfx, Hh^Zfx, Hh^Zfx, Hh^Zfx, Gs^Fms, Hh^Zfx, Hh^Zfx, Hh^Zfx, Hh^Zfx, Hh^Zfx, Hh^Zfx, Gs^Fms, Gs^Fms, Gs^Fms, Hh^Zfx, Hh^Zfx, Hh^Zfx, Hh^Zfx, Hh^Zfx
Hh^Zfx, Hh^Zfx, Hh^Zfx, Hh^Zfx, Hh^Zfx, Gs^Fms, Hh^Zfx, Hh^Zfx, Hh^Zfx, Hh^Zfx, Hh^Zfx, Hh^Zfx, Gs^Fms, Gs^Fms, Gs^Fms, Hh^Zfx, Hh^Zfx, Hh^Zfx, Hh^Zfx, Hh^Zfx
Hh^Zfx, Hh^Zfx, Hh^Zfx, Hh^Zfx, Hh^Zfx, Gs^Fms, Hh^Zfx, Hh^Zfx, Hh^Zfx, Hh^Zfx, Hh^Zfx, Hh^Zfx, Gs^Fms, Gs^Do, Gs^Fms, Hh^Zfx, Hh^Zfx, Hh^Zfx, Hh^Zfx, Hh^Zfx
Hh^Zfx, Hh^Zfx, Hh^Zfx, Hh^Zfx, Gs^Fms, Gs^Fms, Hh^Zfx, Hh^Zfx, Hh^Zfx, Hh^Zfx, Hh^Zfx, Hh^Zfx, Gs^Fms, Gs^Fms, Gs^Fms, Hh^Zfx, Hh^Zfx, Hh^Zfx, Hh^Zfx, Hh^Zfx
Hh^Zfx, Hh^Zfx, Hh^Zfx, Hh^Zfx, Gs^Fms, Hh^Zfx, Hh^Zfx, Hh^Zfx, Hh^Zfx, Hh^Zfx, Hh^Zfx, Hh^Zfx, Gs^Fms, Gs^Fms, Hh^Zfx, Hh^Zfx, Hh^Zfx, Hh^Zfx, Hh^Zfx, Hh^Zfx
Hh^Zfx, Hh^Zfx, Hh^Zfx, Hh^Zfx, Gs^Fms, Hh^Zfx, Hh^Zfx, Hh^Zfx, Hh^Zfx, Hh^Zfx, Hh^Zfx, Hh^Zfx, Gs^Fms, Gs^Fms, Hh^Zfx, Hh^Zfx, Hh^Zfx, Hh^Zfx, Hh^Zfx, Hh^Zfx
Hh^Zfx, Hh^Zfx, Hh^Zfx, Hh^Zfx, Gs^Fms, Gs^Fms, Hh^Zfx, Hh^Zfx, Hh^Zfx, Hh^Zfx, Hh^Zfx, Hh^Zfx, Gs^Fms, Hh^Zfx, Hh^Zfx, Hh^Zfx, Hh^Zfx, Hh^Zfx, Hh^Zfx, Hh^Zfx
Hh^Zfx, Hh^Zfx, Hh^Zfx, Gs^Fms, Gs, Gs^Fms, Gs^Fms, Hh^Zfx, Gs^Fms, Hh^Zfx, Gs^Fms, Gs^Fms, Gs^Fms, Hh^Zfx, Hh^Zfx, Hh^Zfx, Hh^Zfx, Hh^Zfx, Hh^Zfx, Hh^Zfx
Hh^Zfx, Hh^Zfx, Hh^Zfx, Hh^Zfx, Gs^Fms, Gs, Gs^Fms, Gs^Fms, Gs, Gs, Gs, Gs, Gs, Hh^Zfx, Hh^Zfx, Hh^Zfx, Hh^Zfx, Hh^Zfx, Hh^Zfx, Hh^Zfx
Hh^Zfx, Hh^Zfx, Hh^Zfx, Hh^Zfx, Hh^Zfx, Gs^Fms, Gs^Fms, Gs, Gs, Gs, Gs, Gs, Gs, Hh^Zfx, Hh^Zfx, Hh^Zfx, Hh^Zfx, Hh^Zfx, Hh^Zfx, Hh^Zfx
Hh^Zfx, Hh^Zfx, Hh^Zfx, Hh^Zfx, Hh^Zfx, Hh^Zfx, Hh^Zfx, Gs^Fms, Gs, Gs, Gs, Hh, Gs, Hh^Zfx, Hh^Zfx, Hh^Zfx, Hh^Zfx, Hh^Zfx, Hh^Zfx, Hh^Zfx
Hh^Zfx, Hh^Zfx, Hh^Zfx, Hh^Zfx, Hh^Zfx, Hh^Zfx, Hh^Zfx, Gs^Fms, Gs, Gs, Gs, Hh, Hh, Gs^Fms, Hh^Zfx, Hh^Zfx, Hh^Zfx, Hh^Zfx, Hh^Zfx, Hh^Zfx
Hh^Zfx, Hh^Zfx, Hh^Zfx, Hh^Zfx, Hh^Zfx, Hh^Zfx, Hh^Zfx, Gs^Fms, Gs, Gs, Gs, Gs, Gs, Gs, Gs^Fms, Hh^Zfx, Hh^Zfx, Hh^Zfx, Hh^Zfx, Hh^Zfx
Hh^Zfx, Hh^Zfx, Hh^Zfx, Hh^Zfx, Hh^Zfx, Hh^Zfx, Gs^Fms, Gs^Fms, Gs, Gs, Gs, Gs, Gs, Gs, Gs, Hh^Zfx, Hh^Zfx, Hh^Zfx, Hh^Zfx, Hh^Zfx
Hh^Zfx, Hh^Zfx, Hh^Zfx, Hh^Zfx, Hh^Zfx, Hh^Zfx, Gs^Fms, Gs^Fms, Isa, Gs, Gs, Hh, Isa, Gs, Gs, Gs^Fms, Hh^Zfx, Hh^Zfx, Hh^Zfx, Hh^Zfx
Hh^Zfx, Hh^Zfx, Hh^Zfx, Gs^Fms, Gs, Gs^Fms, Gs, Isa, Gs, Gs, Gs, Gs, Gs, Isa, Gs, Gs, Hh^Zfx, Hh^Zfx, Hh^Zfx, Hh^Zfx
Hh^Zfx, Hh^Zfx, Gs^Fms, Gs, Gs, Gs, Gs, Isa, Gs, Gs, Gs, Gs, Gs, Gs, Gs, Gs, Gs^Fms, Hh^Zfx, Hh^Zfx, Hh^Zfx
Hh^Zfx, Hh^Zfx, Gs^Fms, Gs, Gs, Gs, Isa, Gs, Gs, Gs, Xor, Gs, Gs, Gs, Gs, Gs, Gs, Hh^Zfx, Hh^Zfx, Hh^Zfx
Hh^Zfx, Hh^Zfx, Gs^Fms, Gs, Gs, Gs, Isa, Isa, Isa, Xor, Gs, Xor, Xor, Gs, Gs, Gs, Gs, Hh^Zfx, Hh^Zfx, Hh^Zfx
Hh^Zfx, Hh^Zfx, Gs^Fms, Gs, Gs, Isa, Isa, Isa, Isa, Xor, Isa, Gs, Xor, Gs, Gs, Gs, Gs, Gs^Fms, Hh^Zfx, Hh^Zfx
Hh^Zfx, Hh^Zfx, Gs^Fms, Gs, Gs, Isa, Gs, Gs, Gs, Xor, Isa, Xor, Gs, Gs, Gs, Gs, Gs, Gs^Fms, Hh^Zfx, Hh^Zfx
Hh^Zfx, Hh^Zfx, Gs^Fms, Gs, Gs, Gs, Isa, Isa, Gs, Xor, Isa, Xor, Gs, Gs, Gs, Gs, Gs, Hh^Zfx, Hh^Zfx, Hh^Zfx
Hh^Zfx, Hh^Zfx, Hh^Zfx, Gs, Gs, Gs, Gs, Gs, Gs, Gs, Gs, Xor, Gs, Gs, Gs, Gs, Gs^Fms, Hh^Zfx, Hh^Zfx, Hh^Zfx
Hh^Zfx, Hh^Zfx, Hh^Zfx, Gs^Fms, Gs, Gs, Isa, Gs, Isa, Gs, Gs, Gs, Gs, Gs, Gs, Gs, Hh^Zfx, Hh^Zfx, Hh^Zfx, Hh^Zfx
Hh^Zfx, Hh^Zfx, Hh^Zfx, Hh^Zfx, Gs, Gs, Gs, Gs, Isa, Re, Gs, Gs, Gs, Gs, Gs, Gs^Fms, Hh^Zfx, Hh^Zfx, Hh^Zfx, Hh^Zfx
Hh^Zfx, Hh^Zfx, Hh^Zfx, Hh^Zfx, Gs, Gs, Gs, Gs, Isa, Re, Isa, Gs, Gs, Gs, Hh, Hh^Zfx, Hh^Zfx, Hh^Zfx, Hh^Zfx, Hh^Zfx
Hh^Zfx, Hh^Zfx, Hh^Zfx, Hh^Zfx, Gs, Gs, Gs, Gs, Re, Gs, Gs, Gs, Gs, Gs, Gs, Hh^Zfx, Hh^Zfx, Hh^Zfx, Hh^Zfx, Hh^Zfx
Hh^Zfx, Hh^Zfx, Hh^Zfx, Hh^Zfx, Gs, Gs, Re, Re, Gs, Re, Gs, Gs, Gs, Gs, Hh, Gs^Fms, Hh^Zfx, Hh^Zfx, Hh^Zfx, Hh^Zfx
Hh^Zfx, Hh^Zfx, Hh^Zfx, Gs^Fms, Gs, Gs, Re, Gs, Re, Re, Gs, Gs, Gs, Hh, Gs, Hh, Hh^Zfx, Hh^Zfx, Hh^Zfx, Hh^Zfx
Hh^Zfx, Hh^Zfx, Hh^Zfx, Gs^Fms, Gs, Hh, Re, Re, Re, Gs, Gs, Gs, Gs, Gs, Gs^Fms, Hh, Hh^Zfx, Hh^Zfx, Hh^Zfx, Hh^Zfx
Hh^Zfx, Hh^Zfx, Hh^Zfx, Gs^Fms, Gs^Fms, Gs, Gs, Re, Re, Gs, Hh, Gs, Gs^Fms, Gs^Fms, Hh^Zfx, Hh^Zfx, Hh^Zfx, Hh^Zfx, Hh^Zfx, Hh^Zfx
Hh^Zfx, Hh^Zfx, Hh^Zfx, Hh^Zfx, Hh^Zfx, Gs^Fms, Gs^Fms, Gs, Re, Hh, Gs, Gs^Fms, Gs^Fms, Hh^Zfx, Hh^Zfx, Hh^Zfx, Hh^Zfx, Hh^Zfx, Hh^Zfx, Hh^Zfx
Hh^Zfx, Hh^Zfx, Hh^Zfx, Hh^Zfx, Hh^Zfx, Hh^Zfx, Gs^Fms, Re, Gs, Hh, Gs^Fms, Gs^Fms, Hh^Zfx, Hh^Zfx, Hh^Zfx, Hh^Zfx, Hh^Zfx, Hh^Zfx, Hh^Zfx, Hh^Zfx
Hh^Zfx, Hh^Zfx, Hh^Zfx, Hh^Zfx, Hh^Zfx, Hh^Zfx, Gs^Fms, Gs, Gs^Fms, Hh, Gs^Fms, Hh^Zfx, Hh^Zfx, Hh^Zfx, Hh^Zfx, Hh^Zfx, Hh^Zfx, Hh^Zfx, Hh^Zfx, Hh^Zfx
Hh^Zfx, Hh^Zfx, Hh^Zfx, Hh^Zfx, Hh^Zfx, Hh^Zfx, Gs^Fms, Gs^Fms, Rb, Gs^Fms, Hh^Zfx, Hh^Zfx, Hh^Zfx, Hh^Zfx, Hh^Zfx, Hh^Zfx, Hh^Zfx, Hh^Zfx, Hh^Zfx, Hh^Zfx
Hh^Zfx, Hh^Zfx, Hh^Zfx, Hh^Zfx, Hh^Zfx, Gs^Fms, Gs^Fms, Gs^Fms, Rb, Gs^Fms, Hh^Zfx, Hh^Zfx, Hh^Zfx, Hh^Zfx, Hh^Zfx, Hh^Zfx, Hh^Zfx, Hh^Zfx, Hh^Zfx, Hh^Zfx
Hh^Zfx, Hh^Zfx, Hh^Zfx, Hh^Zfx, Hh^Zfx, Gs^Fms, Gs^Fms, Gs^Fms, Gs^Fms, Rb, Hh^Zfx, Hh^Zfx, Hh^Zfx, Hh^Zfx, Hh^Zfx, Hh^Zfx, Hh^Zfx, Hh^Zfx, Hh^Zfx, Hh^Zfx
Hh^Zfx, Hh^Zfx, Hh^Zfx, Hh^Zfx, Hh^Zfx, Gs^Fms, Gs^Fms, Gs^Fms, Gs^Fms, Rb, Gs^Fms, Hh^Zfx, Hh^Zfx, Hh^Zfx, Hh^Zfx, Hh^Zfx, Hh^Zfx, Hh^Zfx, Hh^Zfx, Hh^Zfx
Hh^Zfx, Hh^Zfx, Hh^Zfx, Hh^Zfx, Gs^Fms, Gs^Fms, Gs^Fms, Hh, Gs, Rb, Gs^Fms, Hh^Zfx, Hh^Zfx, Hh^Zfx, Hh^Zfx, Hh^Zfx, Hh^Zfx, Hh^Zfx, Hh^Zfx, Hh^Zfx
Hh^Zfx, Hh^Zfx, Hh^Zfx, Hh^Zfx, Gs^Fms, Gs^Fms, Gs^Fms, Gs^Fms, Rb, Rb, Gs^Fms, Hh^Zfx, Hh^Zfx, Hh^Zfx, Hh^Zfx, Hh^Zfx, Hh^Zfx, Hh^Zfx, Hh^Zfx, Hh^Zfx
Hh^Zfx, Hh^Zfx, Hh^Zfx, Hh^Zfx, Hh^Zfx, Gs^Fms, Gs^Fms, Gs^Fms, Gs^Fms, Rb, Gs^Fms, Hh^Zfx, Hh^Zfx, Hh^Zfx, Hh^Zfx, Hh^Zfx, Hh^Zfx, Hh^Zfx, Hh^Zfx, Hh^Zfx
Hh^Zfx, Hh^Zfx, Hh^Zfx, Hh^Zfx, Hh^Zfx, Hh^Zfx, Hh^Zfx, Gs^Fms, Gs^Fms, Rb, Gs^Fms, Hh^Zfx, Hh^Zfx, Hh^Zfx, Hh^Zfx, Hh^Zfx, Hh^Zfx, Hh^Zfx, Hh^Zfx, Hh^Zfx
Hh^Zfx, Hh^Zfx, Hh^Zfx, Hh^Zfx, Hh^Zfx, Hh^Zfx, Hh^Zfx, Hh^Zfx, Hh^Zfx, Ce, Ke, Ce, Hh^Zfx, Hh^Zfx, Hh^Zfx, Hh^Zfx, Hh^Zfx, Hh^Zfx, Hh^Zfx, Hh^Zfx
Hh^Zfx, Hh^Zfx, Hh^Zfx, Hh^Zfx, Hh^Zfx, Hh^Zfx, Hh^Zfx, Hh^Zfx, Hh^Zfx, Ce, Rb, Ce, Hh^Zfx, Hh^Zfx, Hh^Zfx, Hh^Zfx, Hh^Zfx, Hh^Zfx, Hh^Zfx, Hh^Zfx
Hh^Zfx, Hh^Zfx, Hh^Zfx, Hh^Zfx, Hh^Zfx, Hh^Zfx, Hh^Zfx, Hh^Zfx, Hh^Zfx, Gs^Fms, Rb, Gs^Fms, Hh^Zfx, Hh^Zfx, Hh^Zfx, Hh^Zfx, Hh^Zfx, Hh^Zfx, Hh^Zfx, Hh^Zfx
Hh^Zfx, Hh^Zfx, Hh^Zfx, Hh^Zfx, Hh^Zfx, Hh^Zfx, Hh^Zfx, Hh^Zfx, Hh^Zfx, Gs^Fms, Rb, Gs^Fms, Hh^Zfx, Hh^Zfx, Hh^Zfx, Hh^Zfx, Hh^Zfx, Hh^Zfx, Hh^Zfx, Hh^Zfx
