Wog, Wog, Wog, Wog, Wog, Wog, Wog, Wog, Wog, Wog, Wog, Wog, Gd^Eqp, Wog, Wog, Wog, Wog, Wog, Wog, Wog, Wog, Wog, Wog, Wog, Wog, Wog, Wog
Wog, Wog, Wog, Wog, Wog, Wog, Wog, Wog, Gd^Eqp, Gd^Eqp, Gd^Eqp, Gd^Eqp, Gd, Gd^Eqp, Gd^Eqp, Gd^Eqp, Gd^Eqp, Gd^Eqp, Gd^Eqp, Wog, Gd^Eqp, Wog, Wog, Wog, Wog, Wog, Wog
Wog, Wog, Wog, Wog, Wog, Wog, Gd^Eqp, Gd^Eqp, Gd^Dr, Gd^Dr, Gd^Dr, Gd^Dr, Gd^Dr, Gd, Gd, Gd, Gd, Gd, Gd, Gd^Eqp, Gd, Gd^Eqp, Gd^Eqp, Wog, Wog, Wog, Gd
Wog, Wog, Wog, Wog, Wog, Gd^Eqp, Gd^Dr, Gd^Dr, Gd^Dr, Gd^Dr, Gd^Dr, Gd^Dr, Exos, Gd^Dr, Gd, Gd, Gd, Gd, Re, Gd, Re, Gd, Gd, Gd^Eqp, Gd^Eqp, Gd, Gd
Wog, Wog, Wog, Wog, Gd^Eqp, Gd^Eqp, Gd^Dr, Gd^Dr, Gd^Dr, Gd^Dr, Exos, Exos, Re^Dr, Xos, Xos, Re, Re, Re, Xos, Re, Re, Re, Re, Gd, Gd, Gd^Eqp, Gd
Wog, Wog, Wog, Gd, Gd^Eqp, Gd^Dr, Gd^Dr, Gd^Dr, Exos, Exos, Re^Dr, Re^Dr, Re, Re, Xos, Re, Xos, Xos, Re, Xos, Xos, Re, Re, Re, Gd, Gd^Eqp, Gd
Wog, Wog, Wog, Gd^Eqp, Gd, Gd, Re^Dr, Exos, Re^Dr, Re^Dr, Re, Re, Re, Re, Xos, Re, Xos, Re, Re, Re, Xos, Re, Re, Re, Gd, Gd^Eqp, Gd
Wog, Wog, Wog^Dr, Gd^Dr, Gd^Dr, Gd, Re, Re, Re^Dr, Re^Dr, Xos, Re, Xos, Xos, Re, Gd, Gd, Xos, Gd, Xos, Gd, Re, Re, Re, Gd, Gd^Eqp, Gd
Wog, Wog, Wog, Gd^Eqp, Gd, Gd, Re, Re, Xos, Xos, Re, Xos, Gd, Gd, Re, Re^Ecf, Gd, Gd, Re, Gd, Gd, Re, Re, Re, Xos, Xos, Xos
Wog, Wog, Wog, Gd^Eqp, Gd, Gd, Re, Re, Re, Re, Re, Gd, Re, Re, Re, Re, Re, Re, Re, Re, Re, Re, Xos, Xos, Iwr, Iwr, Xos
Wog, Wog, Wog, Gd^Eqp, Re, Gd, Re, Re, Re, Re, Re, Re, Re, Re, Re, Re, Re, Re, Re, Re, Re, Re, Iwr, Iwr, Isr, Qxu, Xos
Wog^Bw/, Wog^Bw\, Wog^Bw/, Re^Pw\o, Re, Re, Re, Re, Re, Re, Re, Re, Re, Re, Re, Re, Re, Re, Re, Re, Re, Re, Xos, Iwr, Iwr, Qxu, Xos
Wog, Wog, Wog, Gd^Eqp, Gd^Eqp, Gd, Gd, Re, Re, Gd, Gd, Gd, Re, Re, Re, Re, Re, Re, Gd, Gd, Re, Re, Re, Xos, Xos, Iwr, Xos
Wog, Wog, Wog, Wog, Gd^Eqp, Gd, Gd, Re, Re, Xos, Xos, Gd, Gd, Re, Re, Re, Re, Re, Gd, Xos, Xos, Re, Re, Re, Gd, Xos, Gd
Wog, Wog, Wog, Wog, Gd^Eqp, Gd^Wm, Gd, Re, Xos, Re, Re, Xos, Xos, Gd, Gd, Gd, Gd, Xos, Re, Re, Xos, Re, Re, Re, Gd, Gd^Eqp, Gd
Wog, Wog, Wog, Wog, Gd^Eqp, Gd, Gd, Re, Xos, Re, Re, Re, Re, Xos, Xos, Gd, Re, Xos, Re, Re, Re, Xos, Re, Re, Gd, Gd^Eqp, Gd
Wog, Wog, Wog, Wog, Gd^Eqp, Gd, Gd, Gd, Re, Xos, Xos, Re, Re, Re, Xos, Re, Re, Xos, Xos, Re, Xos, Xos, Re, Re, Gd, Gd^Eqp, Gd
Wog, Wog, Wog, Wog, Gd^Eqp, Gd, Gd, Gd, Re, Re, Re, Xos, Xos, Re, Gd, Gd, Gd, Re, Re, Re, Re, Re, Re, Gd, Gd^Eqp, Gd^Eqp, Gd
Wog, Wog, Wog, Wog, Wog, Gd^Eqp, Gd, Gd, Gd, Re, Re, Re, Gd, Xos, Gd, Gd, Gd, Gd, Gd, Re, Gd, Re, Gd^Eqp, Gd^Eqp, Wog, Gd, Gd
Wog, Wog, Wog, Wog, Wog, Gd^Eqp, Gd^Eqp, Gd, Gd, Gd, Gd, Gd, Gd, Gd, Gd, Gd, Gd, Gd, Gd, Gd, Gd^Eqp, Gd^Eqp, Gd, Gd, Wog, Gd, Gd
Wog, Wog, Wog, Wog, Wog, Wog, Gd, Gd^Eqp, Gd^Eqp, Gd^Wm, Gd^Eqp, Gd, Gd, Gd, Gd, Gd, Gd^Eqp, Gd, Gd^Eqp, Gd^Eqp, Gd, Gd, Wog, Wog, Wog, Wog, Wog
Wog, Wog, Wog, Wog, Wog, Wog, Wog, Gd, Gd, Gd^Eqp, Gd, Gd^Eqp, Gd^Eqp, Gd^Eqp, Gd^Eqp, Gd^Eqp, Gd, Gd^Eqp, Gd, Gd, Wog, Wog, Wog, Wog, Wog, Wog, Wog
Wog, Wog, Wog, Wog, Wog, Wog, Wog, Wog, Wog, Gd, Wog, Gd, Gd, Gd, Gd, Gd, Wog, Gd, Wog, Wog, Wog, Wog, Wog, Wog, Wog, Wog, Wog
