Xoi, Dd, Xoi, Xoi, Xoi, Xoi, Xoi, Dd, Xoi, Dd, Xoi, Dd, Xoi, Dd, Xoi, Xoi, Xoi, Xoi, Xoi, Xoi, Xoi, Xoi, Xoi, Dd, Xoi, Dd, Dd, Dd, Dd
Xoi, Xoi, Rrd, Cd, Cd, Cd, Rrd, Xoi, Rrd, Xoi, Rrd, Xoi, Rrd, Xoi, Rrd, Rrd, Cd, Cd, Rrd, Rrd, Rrd, Rrd, Rrd, Xoi, Rrd, Xoi, Dd, Dd, Dd
Mdd^Xm, Rrd, Rrd, Rrd, Rrd, Rrd, Rrd, Xoi, Rrd, Rrd, Xoi, Rrd, Xoi, Rrd, Xoi, Xoi, Xoi, Xoi, Xoi, Xoi, Xoi, Xoi, Xoi, Rrd, Rrd, Xoi, Dd, Dd, Dd
Mdd^Xm, Rrd, Rrd, Rrd, Rrd, Rrd, Rrd, Xoi, Rrd, Xoi, Rrd, Xoi, Rrd, Xoi, Rrd, Rrd, Rrd, Rrd, Rrd, Rrd, Rrd, Rrd, Rrd, Xoi, Rrd, Xoi, Dd, Dd, Dd
Mdd^Xm, Cd, Cd, Cd, Cd, Rrd, Rrd, Xoi, Xoi, Rrd, Rrd, Rrd, Rrd, Rrd, Rrd, Rrd, Rrd, Rrd, Rrd, Rrd, Rrd, Rrd, Rrd, Xoi, Rrd, Xoi, Dd, Dd, Dd
Mdd^Xm, Cd, Rrd, Cd, Xoi, Rrd, Rrd, Rrd, Xoi, Cd, Rrd, Rrd, Rrd, Rrd, Rrd, Rrd, Rrd, Rrd, Xoi, Xoi, Xoi, Xoi, Xoi, Xoi, Rrd, Xoi, Xoi, Dd, Dd
Mdd^Xm, Rrd, Rrd, Rrd, Xoi, Rrd, Rrd, Rrd, Xoi, Cd, Xoi, Rrd, Rrd, Rrd, Wot, Wot, Wot, Rrd, Xoi, Cd, Cd, Cd, Rrd, Rrd, Rrd, Rrd, Xoi, Dd, Dd
Mdd^Xm, Rrd, Rrd, Rrd, Rrd, Xoi, Rrd, Rrd, Rrd, Xoi, Cd, Xoi, Xoi, Rrd, Xoi, Wot, Xoi, Rrd, Xoi, Rrd, Rrd, Cd, Cd, Cd, Cd, Xoi, Dd, Dd, Dd
Mdd^Xm, Cd, Cd, Rrd, Rrd, Xoi, Xoi, Rrd, Rrd, Rrd, Cd, Cd, Cd, Xoi, Rrd, Xoi, Rrd, Xoi, Rrd, Rrd, Xoi, Rrd, Xoi, Cd, Xoi, Xoi, Mdd^Xm, Dd, Mdd^Xm
Mdd^Xm, Cd, Cd, Rrd, Rrd, Cd, Cd, Xoi, Xoi, Rrd, Xoi, Cd, Xoi, Rrd, Xoi, Rrd, Xoi, Rrd, Xoi, Xoi, Rrd, Xoi, Cd, Xoi, Rrd, Rrd, Mdd^Xm, Mdd^Xm, Mdd^Xm
Mdd^Xm, Cd, Cd, Rrd, Rrd, Cd, Cd, Cd, Cd, Xoi, Rrd, Xoi, Rrd, Xoi, Cd, Xoi, Rrd, Xoi, Cd, Cd, Rrd, Rrd, Rrd, Cd, Cd, Rrd, Mdd^Xm, Mdd^Xm, Mdd^Xm
Mdd^Xm, Cd, Cd, Rrd, Rrd, Cd, Rrd, Cd, Rrd, Rrd, Rrd, Rrd, Rrd, Rrd, Rrd, Cd, Cd, Cd, Rrd, Rrd, Rrd, Rrd, Rrd, Rrd, Cd, Cd, Mdd^Xm, Mdd^Xm, Mdd^Xm
Mdd^Xm, Cd, Cd, Rrd, Rrd, Rrd, Rrd, Rrd, Rrd, Rrd, Rrd, Cd, Rrd, Rrd, Rrd, Rrd, Cd, Cd, Rrd, Rrd, Rrd, Rrd, Rrd, Rrd, Rrd, Rrd, Mdd^Xm, Mdd^Xm, Mdd^Xm
Mdd^Xm, Cd, Cd, Rrd, Rrd, Rrd, Rrd, Rrd, Rrd, Rrd, Mdd^Xm, Cd, Mdd^Xm, Rrd, Rrd, Rrd, Rrd, Rrd, Rrd, Rrd, Mdd^Xm, Mdd^Xm, Mdd^Xm, Rrd, Rrd, Rrd, Mdd^Xm, Mdd^Xm, Mdd^Xm
Mdd^Xm, Xoi, Xoi, Xoi, Rrd, Rrd, Rrd, Rrd, Rrd, Xoi, Mdd^Xm, Mdd^Xm, Mdd^Xm, Mdd^Xm, Mdd^Xm, Rrd, Mdd^Xm, Rrd, Mdd^Xm, Mdd^Xm, Rrd, Rrd, Rrd, Rrd, Mdd^Xm, Rrd, Mdd^Xm, Mdd^Xm, Mdd^Xm
Mdd^Xm, Mdd^Xm, Mdd^Xm, Xoi, Rrd, Rrd, Rrd, Rrd, Rrd, Xoi, Mdd^Xm, Mdd^Xm, Mdd^Xm, Mdd^Xm, Mdd^Xm, Mdd^Xm, Mdd^Xm, Mdd^Xm, Dd, Dd, Rrd, Mdd^Xm, Mdd^Xm, Mdd^Xm, Mdd^Xm, Mdd^Xm, Mdd^Xm, Mdd^Xm, Mdd^Xm
Mdd^Xm, Mdd^Xm, Mdd^Xm, Xoi, Rrd, Rrd, Rrd, Rrd, Rrd, Xoi, Mdd^Xm, Mdd^Xm, Mdd^Xm, Mdd^Xm, Mdd^Xm, Mdd^Xm, Mdd^Xm, Dd, Dd, Dd, Rrd, Dd, Dd, Mdd^Xm, Mdd^Xm, Mdd^Xm, Mdd^Xm, Mdd^Xm, Mdd^Xm
Mdd^Xm, Mdd^Xm, Mdd^Xm, Xoi, Rrd, Rrd, Rrd, Rrd, Rrd, Xoi, Mdd^Xm, Mdd^Xm, Mdd^Xm, Mdd^Xm, Mdd^Xm, Mdd^Xm, Mdd^Xm, Dd, Dd, Dd, Rrd, Dd, Dd, Mdd^Xm, Mdd^Xm, Mdd^Xm, Mdd^Xm, Mdd^Xm, Mdd^Xm
Mdd^Xm, Mdd^Xm, Mdd^Xm, Xoi, Xoi, Rrd, Rrd, Rrd, Rrd, Xoi, Mdd^Xm, Mdd^Xm, Mdd^Xm, Mdd^Xm, Mdd^Xm, Mdd^Xm, Mdd^Xm, Dd, Dd, Dd, Rrd, Dd, Dd, Mdd^Xm, Mdd^Xm, Mdd^Xm, Mdd^Xm, Mdd^Xm, Mdd^Xm
Mdd^Xm, Mdd^Xm, Mdd^Xm, Mdd^Xm, Xoi, Rrd, Rrd, Rrd, Rrd, Xoi, Mdd^Xm, Mdd^Xm, Mdd^Xm, Mdd^Xm, Mdd^Xm, Mdd^Xm, Mdd^Xm, Dd, Dd, Dd, Rrd, Dd, Dd, Mdd^Xm, Mdd^Xm, Mdd^Xm, Mdd^Xm, Mdd^Xm, Mdd^Xm
Mdd^Xm, Mdd^Xm, Mdd^Xm, Mdd^Xm, Xoi, Xoi, Cd, Xoi, Xoi, Xoi, Mdd^Xm, Mdd^Xm, Mdd^Xm, Mdd^Xm, Mdd^Xm, Mdd^Xm, Mdd^Xm, Dd, Dd, Dd, Rrd, Dd, Dd, Mdd^Xm, Mdd^Xm, Mdd^Xm, Mdd^Xm, Mdd^Xm, Mdd^Xm
Mdd^Xm, Mdd^Xm, Mdd^Xm, Mdd^Xm, Xoi, Cd, Cd, Cd, Cd, Xoi, Mdd^Xm, Mdd^Xm, Mdd^Xm, Mdd^Xm, Mdd^Xm, Mdd^Xm, Mdd^Xm, Dd, Dd, Dd, Rrd, Dd, Dd, Mdd^Xm, Mdd^Xm, Mdd^Xm, Mdd^Xm, Mdd^Xm, Mdd^Xm
Mdd^Xm, Mdd^Xm, Mdd^Xm, Mdd^Xm, Xoi, Cd, Kd, Kd, Cd, Xoi, Mdd^Xm, Mdd^Xm, Mdd^Xm, Mdd^Xm, Mdd^Xm, Mdd^Xm, Mdd^Xm, Dd, Dd, Dd, Rrd, Dd, Dd, Mdd^Xm, Mdd^Xm, Mdd^Xm, Mdd^Xm, Mdd^Xm, Mdd^Xm
Mdd^Xm, Mdd^Xm, Mdd^Xm, Mdd^Xm, Xoi, Cd, Cd, Cd, Cd, Xoi, Mdd^Xm, Mdd^Xm, Mdd^Xm, Mdd^Xm, Mdd^Xm, Mdd^Xm, Mdd^Xm, Dd, Dd, Dd, Rrd, Dd, Dd, Mdd^Xm, Mdd^Xm, Mdd^Xm, Mdd^Xm, Mdd^Xm, Mdd^Xm
Mdd^Xm, Mdd^Xm, Mdd^Xm, Mdd^Xm, Xoi, Cd, Xoi, Cd, Xoi, Xoi, Mdd^Xm, Mdd^Xm, Mdd^Xm, Mdd^Xm, Mdd^Xm, Mdd^Xm, Mdd^Xm, Dd, Dd, Dd, Rrd, Dd, Dd, Mdd^Xm, Mdd^Xm, Mdd^Xm, Mdd^Xm, Mdd^Xm, Mdd^Xm
Mdd^Xm, Mdd^Xm, Mdd^Xm, Mdd^Xm, Mdd^Xm, Xoi, Mdd^Xm, Xoi, Mdd^Xm, Mdd^Xm, Mdd^Xm, Mdd^Xm, Mdd^Xm, Mdd^Xm, Mdd^Xm, Mdd^Xm, Mdd^Xm, Dd, Dd, Dd, Rrd, Dd, Dd, Mdd^Xm, Mdd^Xm, Mdd^Xm, Mdd^Xm, Mdd^Xm, Mdd^Xm
Mdd^Xm, Mdd^Xm, Mdd^Xm, Mdd^Xm, Mdd^Xm, Mdd^Xm, Mdd^Xm, Mdd^Xm, Mdd^Xm, Mdd^Xm, Mdd^Xm, Mdd^Xm, Mdd^Xm, Mdd^Xm, Mdd^Xm, Mdd^Xm, Mdd^Xm, Dd, Dd, Dd, Rrd, Dd, Dd, Mdd^Xm, Mdd^Xm, Mdd^Xm, Mdd^Xm, Mdd^Xm, Mdd^Xm
Mdd^Xm, Mdd^Xm, Mdd^Xm, Mdd^Xm, Mdd^Xm, Mdd^Xm, Mdd^Xm, Mdd^Xm, Mdd^Xm, Mdd^Xm, Mdd^Xm, Mdd^Xm, Mdd^Xm, Mdd^Xm, Mdd^Xm, Mdd^Xm, Mdd^Xm, Dd, Dd, Dd, Rrd, Dd, Dd, Mdd^Xm, Mdd^Xm, Mdd^Xm, Mdd^Xm, Mdd^Xm, Mdd^Xm
Mdd^Xm, Mdd^Xm, Mdd^Xm, Mdd^Xm, Mdd^Xm, Mdd^Xm, Mdd^Xm, Mdd^Xm, Mdd^Xm, Mdd^Xm, Mdd^Xm, Mdd^Xm, Mdd^Xm, Mdd^Xm, Mdd^Xm, Mdd^Xm, Mdd^Xm, Dd, Dd, Dd, Rrd, Dd, Dd, Mdd^Xm, Mdd^Xm, Mdd^Xm, Mdd^Xm, Mdd^Xm, Mdd^Xm
